9 144
52 12
73 114
29 66
45 37
31 157
73 28
18 108
26 7
76 131
11111111111101110011111111110111011101001001b1111011011111011010111101111111101011111011001111001101011011111111a01110101111101111111111101011110111101110111111
11111111101111111111001101111111111110111100a1100011111111111111011110111101011101101110111110111011111111110011a01111111111111001110111111111111001111101111111
11011111110111111110111101011111111111010101a1101111111111111111111110110111101110111100111111111011110111111110a11101101101111101110111111111111111111001011111
11111110111111011111100111111011111001111101a1111011010111111110111111111010111111011111111012022120010202200122a21111221212111101110111101101101111111110111011
11111111111111111111011101110111111111110110a1101110111101011111111111111011111101110111111111210200220021101022a01110211121111111011011111111001111111011111110
11111111110110111110101111111111110010111010a1111111111001011111111111111110111111110111111110011222112211102121b21111212202111111111111101110111101111011110010
10101111110001111111111100110010111110110111a1111111110101111111111101111111111011001110001111212120221022112111a12201122222111111011111111111110101111011111110
11111101111111111101111111100111111111111101a1011111111101111100111011111111011111101011111102211121201100012002b11220101211111110111010111011111001111001110101
11010111100111111111111111101111111111000111a1011111111111111100101111011110101110110001000111221011122012221011b11111121022100011111111111111111011111111111111
11110110101110111111111011001110111111111111a1111111101101110011111111111010111111111111111110111102111222111111b21022210101111111001101111011111100111111111110
10101011101001011111111111110111111111101110a1111111111111101111111111110111111110110111111111022222211112122212b11122122020111010011111111111101111110111110111
22111102212222001110122011111100001111011101a1101111101111101011011111101101011111111011011111220012222112211121b10022221222111111111110111111111100101100111111
11201210211211120122121111101111110111111100a0111101111110111111111001011011111110011110111101201112121112220202a11211221120111011111111101101101110111110110110
10110211110121111022101110111111111111111111a1011101111000100110111111100110111110110100011111001112211111011112b12112122121111111111100111111110111110111111111
01002021022222220222212111100101111111111111a0111112211101110210111221021112210112011101111110112220220101101212a02202202002101101111111001111101111111111111110
10202122121111012011211111110111101111111111a1011112121120011201022211212122211122111011011012121011212120210112b20001121202111111010010011101111110100110010111
22220202210221122110211011010011111111110111a1111012021211101112121022111002121112111111010110211122221110222111a21201111222111111101001011101112122122202222220
22201221121122010212021110111111111111010111a1111110021210022200222101220200121220111111110100211211021102222021b01210100101011010001101011111221210110121222022
20112210211112010222112111101111111111111111a1001110212110211222200120221111122121111111001110101010211210011210a00122121102110101101111101111110121211222201210
12222221001102211001211111111111110110110111a0111111001202220211102202002122222211110110111101211212111222112101a20212011222110101110111101101220222212212112012
ababbababaabaabaabaaaaaaaaa11011111101101101a0110110221010222122011120122112111211100101011112110200212001000010a20112200111111110111110111111220120222022222022
10222110122112112220222111a11111101101111111a1011112121221010212101002112121020202111100111112122220212221212201a01111211120111111110111011111011121212212122211
21021122122110120002111101a11111111100101010a1011112222111111012020221112211211122101110011111110122212022222112a11112122121111011011010111101201111122022002100
22211010202211201222122111a10111111111111011a1111011101212122222221112212202011210111110101010121102210101111212b12222212020101111101111111011011122021122112022
02121111211112220221221111a10111010110101110a0101102121222221121101121211010011221101111101111112121102211112202b12102120112111111111111110111120112222121102111
22221121220201122210212111a11101110111110111a1101111100002011221122122212112201111111111011112112222100111221111a11112112012111011101110111111202112121012122112
12211222021222100201210111a10111111111111111a0111112222212221212011222201001122121111101111111101021212212210022b22212210110111111010111111111121222212212002211
10220222202121210120210111a11110111100111111a1111100120112111112221221111002220222111110111101212201201111011210a21201201210100111111111011111000111111102200121
01202212012112110121021111a11111111111011011a0111112211222011022212102201112121020100111011011111122122121212121b22211122110111111111010111111222222112211101102
21122011122001102222011101a10111111111111111a1111112212210112212211212221012122221111011110112122022112122221002a11221012200111111111101110110201121222221212101
21121121212122201222221111a22211220111022210b1102120222110201221012220122110121101010011001111111012020221210210a01111210102011110010111111111121110120221121220
21101120221012011111220111a21021222111222210b2022212222210012222112101212211211112111111001111211122101221211100a20112222101111110010101111111222202120222120112
21120012121012120212102111a11220211212010222a1222222212211112222212012222220112202100111110112112220001202201121a22120102122110111111111110110021112122012012110
12112222210111122201212201b22001221222112211b1122200212021212221210211122222112111111110111102111111021110120011a22222111110101110111101111111011211221221111121
11111221011011222022102212b12221200122200020a2021022211012121111211112112211210202111111111010110111110111111011a11001111111111111111101101111221111211122021121
22022212012222002122111212a22222222210021121a0211212111111012100001122222201111211101011011110111111100010101100a11111110111101111110110101111200000202122201111
01121011201122112121110221b21122122021021221a1221202221121121120211100122111202122100111101111111000010111111111a11101110111111111111111011000221221112012110202
11012121122222121222220120b11110121221010120b2120110221211221122212002122112121222111111001011101001111110011101a01111111111110111111110110011221122202222212221
21201222221211122222222101b01121021202100101a2222120101221001222221111212221202011111111111111101101111101111111a11100011111111111110111101011211120001221021012
21222001222222002212222212b11122011020102212a2211111211100212122221211000011221112111111111100111011011111110111a11111101001111010111111110110101110122011212002
22221221002200120111222210b11211112211112211a1020222022210222212020102211122021221011111111011111111011111100111a01111011011110111110001111111220002121122202121
00121202211121112122112212a02221202222012222a1112210021222101211011122212222211221111001110111111111101111111110a10110101111100011111011111111020211101201102010
11001011111111111111012121a11102102212022211a0102020210102200112221122112210011202111111111111110101111011111100a11011111111111111101011111001210122212201222011
11111101101111111101012202b11110201210012211a1022112220011121111111220020012121122010111110111011101001111011011a11111110111111111011110111111122210222122011112
11111101111111101111102122a10021212121001001a1121101211011022012221221211200101120111111111111111011101111111111a01110110111111111111011111111121210112221221121
11111101111111111110102210b12122112210222222a1122101111111101110111111101101111110111111000110110111111010111111a10111100111111111110111110101202121211121201202
11111011011100011111112112a21200122122110122a1111020110111101111111111111001011111111011010101111100111010101111a01011011001111010100101111001202111120202211022
11101111111011111101112212a11212112222120202a2202112211111011111101110111011101110111111111101111000110110111101a11101111110011111111101111111111111111111110111
11111110011111011111012201b20212111211212211b2122211111011110011111001111111111111101011111001101110011111111011a10111011111011011111111100111110011011111111111
11111011101111110111010121a12221210121022010b0221211010011011000100110011110110111111110111101011111111111111111a11111111011111111111011111111110101111111110111
11011111111111011111112112a11000121212122221a2221120111111101111011011011100111110110011111111110111101111101111a11101111111111111001111101010101010111111101111
11111110011110111111012210b02212222001010020b2220121111110111011111011011001111011110111111110001011011111111101a11010111111101101110111111111110111111101111100
11111111111111111010112212a20021021222121022a0201120101111111100111001111111111110111111111010110111111111111101a10101111111111101110111101111110111111111101101
11111011111110111111101212a01122200122021222b2002220011111110111011111111110111111111111110111111011011111111011a10111101111111100111101111101110111010110111111
11110110110110111110011101b21212102002201220b0211022011111110011101111111010101101111010011111111111111110111011a10111111111111001111100111111101111011111110111
11001111111111011101110011a12010222211122201a2211220111101101101111111011111110110111111010001101011101011110101a11110111010100110011101111111011110101111101110
01111110111110111001111112a10001211210212222a1121000211010111101101111110111111111111111111111101101111011111110a11111111001110111111110100101111100000101111011
10111101111111110001102120b21110211222122211b2121110111010111111101111111111111111101111111101111101110110011100a10101001111011010111101011111110111100111110111
11011111111101122021012022a22222220012012212a1221101111110111111111111111010101111110111110100111111112100122112a21110201011222212011111010111110111111110111101
11111100101112222120212222b20221222020222120b22112221110101111111111011101101010111111011110aaaaaaaabaababbaaaabb12111120210121212011111110111111111111110111010
11011111101111011211202212b02202012002222221a12210021101101111111111110111111101110100111111a1110102202212110011220200001210212111100111111111101111111101110111
10111001111111221120121112b02221221220101100a10101011111111011111110111100111111110011111101a1011111021221111112100222222022022020021101100222202211111001011111
11011011011111201012111211b11120110102021201a11101011111110111110110111111111111111000111111a1101112111111212222201112222222212220221102001222211111110111111001
11111111111111011121202102a12101111112211002a10111101111111111011111110111010001010011110111a0100100111102122021202222222222212122202222221212021100110110111111
00111111011110210100121112b21212110110101021a00100111111011110011101011110001111111111111011a1110101211111121021102102222222222202110011111201202210010111001111
11101101011112022211100222b00202121122220202a00111011111111110111100110111001110011111111111a1101110120101111201211022222020212210002121001211212221110111011111
11101111111010002112111111a21222021222111222a11100101111111111111111111111111001111011011111a111011221222020111020021222bababbbbbbaabbabbababbbababaaaaaaaaaaaaa
11111111111110011121122021b01021121112120102a11111111111111100101110111100111011111111101001a101111011122122211221212222b221212222011011122222120111111111111110
10101110111111211212122220a21021122112100122a11111111111111111110111111111111111110110111010a011111201022121121122221222b011222222021211121202120100111110111101
11111101101110121021202121a01211112011102112a11111111100111111111111111101111111111010111111a110111211222122011101222222b221202221220120112121121211111111011010
11001101111112212212211201b22222020010211212a11001111011001111001111011111011011111110101101a111001202211012021121222221b200221212022100112122121120111011111111
10111110101110101111101200b22210211200221110a11111011110110101111111111110111111100001101111a111011110120211221012212202b022120112022212022211012101111111111011
11111111011102002100020202b20220112211221221a11111111111100111111111111101111111111011110011a111101111122122201120210222a212202222000222212012110221110111111111
01111001110011221111012121a21111212212121221a11111001101111111111111111111011110111111101111a111101001212212212212112022b221022222220122201011121221111110100111
11111100111111210021122211a11221222211012121a01111011111111101111111111101111111111100111110a011111222211211201221121022b202202212021011102121002121111111111011
01011011110110112111222120a10200221122212111a11111110110101111111111100111011101110111101110a110110120112201221110012102b110202002121201121220021121100111101101
11110100111111211001212220b20110102222111202a10111111011010010101111110001111111111011011010a111011220111011202211220222a220002212102011012210101121111111111011
11111110111112121201211200a21121121111202011a10111101111011011010100101011011111111111101111a010111111212110220111012002b120212122220201122101011111111111111111
11111101111111210102122221b02011202220222022a11111110100110010111110111111111111111111111111a100010120220011211200222212a202222220120222212112221111111110110111
11111111110112002120121112b10220221120122001a01101111101111111011111011111111111111111000111a101111010110222221121002222a201222002112200201211101211110101111111
00111111111111111122202011a21010001211112222a11011101111111110011111111111111111111110111110a111111210220021222221002221a211211220112102211221111211111111111111
11111011010112222022212221b12111211201122012a11101111111011101111101101111111110011110111110a111010221220121011212211222a221101112121122121211221211011111111101
00100101111111100121121122a02202221122221212a01111110111011101111101101010011011111111110010a111111012122222111201010122a122102002202202012112011011111101111011
11111111011012112221220111b12210110112012011a11111111111111101011101111111000101011111101111a111111011111211222121122022a012021210201222121220122111110111101110
11111011111112121121210021a12001021222011010a11010111100111111111011101011111011111101111100a011001212111210112111112212b222122222111111122110201221111011110110
10111111111111012211221121a22210100022212122a11111111111110110111111111101110011111111110110a111111210221002201012022212b222202122212122121110211011011011011111
01111011111110100210121122a20112010212221221a11111110110111111101111111100111111101101110111a011111212122120221212022102babbabbbbbabaaaaaabab1122121001101011011
10111111111110112212101122b01021211211102222a11111100111111101100111111011111110010111111101a11111111222002012112020202220122212021122212212b2112211111111111101
10111111011011221122112122a12012201111012221a11011001111010111101111000101101101111011111111a11101121201222201221211212220222220222011221222b0212221010011111101
11101111111111111111100101a11101100110111011a11111111101011111111011111011111011101111111011a11101111111110111011111111221120120220221021121b1202101011011101111
11110111111011110110101010a11111010011011010a10011001111111011111111111111101111111111111100a11101001010000111111111111101112121211201121222a1222210111111110001
11101111101011111111111110a01111111110111110a01111110101011111111110111100111110111100101111a11111011011111110111111212202012112202212011100a1222220110111111011
11010110111111001111111111a01111111100111111a11011011100110111111110101110111111111011111101a11111110111001111111010111111111011011111111010a1110100101111011101
11111111011101111111010111a11111111000101101a01111111111111111111111111111101011011111011001a01010011111111111111011011011111011101101100101a1111101111101111110
11111111111101101111111101a01111111111101010a01110111111110111111101011111010111111110111101a11011110111111111111111111111111101111101111001a1111111111111110110
11110111111111101111110011a11110111111111111a11100101101111011101110111111011011001111111110a11111111111111011111111001111111011111111001110a1111011111111111111
11111111101101111101111111a10111111111100011a01011110111010111111011111100111010011111001111a11111111111101110111111110111011101110111111010a1110111110010011101
01111111111111011101101011a11101111111111101a11100111110110011111111101111111111111011111101a00111111111101100011111111111111111100111111001a1111110011101010111
11110101111111111111111111a11111101111101011a01111110011101011111111111111111001111111001011a11111101111001011011111111101111011111100101111a1101101111101111010
11101111111111101000101011a11011111011111010a11110011011011111101111111111110101111111111101a11110001011011011111011111101111111110011111001a1111111101111110101
11101101110101111011101111a11111110111111110a10111001011100101110111111101011110111100111111a11111111110100111111111100111111111111001111001a0111111111111111000
11101111011101111111111110a11010111011011110a10011111111010111111111111111111011101111111111a11111111111010101110111111111111111111111010111a0111111111110011010
11110111110101111111110111a11111101111111111a11111101110111111011111111011100111101111001111a11010011111101111111111111100101111111110001111a1101110111001111100
11111111111111111110111000a11111111110011110a01111111111111011100111111011000111111111111011a11010011111111010111101111101111111110111111110a1111111111101111011
10111101111111101101111111a11011111111110011a11111111101101110111111111111111101111111111111a11111111011111111110111111111011111111110111110a1111111011101111011
11111101111011111111001101a11100111111111011a10111101111111111100100111111110101011110100111a11100101011111110011111111101011111101111111111a1111111011111111111
11111111111011100110110111a11011111011111101a10111110101111111101101101101011111111011011110a10011111101010110111001111101111110111100101111a1111110111110111111
11011100011011010111101111a10111101111111111a10110111111011110111111001111111110111111111111a11101110111111111101110111111101111011111111111a1111010101010111011
01111101111011111110110111a11111111101111111a01111111111110111111110110101111110111110111111a11111111110111110111111110111111111111111111111a0111100011000111110
11110111110111111111111011a11111111111111011a10010100111111011111110111111111110111100101111a01011111100111010111111111111110111111111111111a1111111111101110111
11111111111110111111111111a11101111111111110a11100111111111111101011101111111111111110111111a01011111111111011101111011111111110111111111001a0111111011100101110
11101111111111101111100111a11101011101111111a10011111111010111111111011010110111101011111111a11111111111101111111010111111110111111111111111a0011101010111111111
11101111111111110011111111a11110011111110110a10111101111111101111111111111111111111100101100a11011101101011111111111110111111111111111101111a1111111110010111101
01110111111110111011111111a10101111110101100a11111111011011011111011111111011110111001111111a10111111111111011101110110111111110010111111111a1111111111110101111
11110011011111110001011111a10111111101111111a11111111111111111111111010100111110111111111100a11111011011011100111001110111111111011101110110a1101111101111011101
11011110111111111111111111a11111001101111111a01111111111111111111101111111111111111110011111a11111101111111011111101011110111101010111001111a1111111111010011011
11111111110101110011111111a11011111111011110a01111110011111111111100111111011011101110011111a11111011111111010111111110111111111111111001111a1111111111111111111
11110010011111111110111111a01110111111111101a11111111111111111111101011001110111111111111110a11110111101101111111011111110101111100101110101a1011111111111111011
01111110101011111101100111a11110110101011011a01011111001111111100101111111111111111110111011a11110111111111011111110100111001111111111111111a1010111111101101011
11001110111101110111001111a11101111111101111a10111010111111111110111110110100111011011110111b11111101101110110111111111111111111100111111110a0111111011111111101
