108 144
7 158
62 107
33 141
51 156
107 106
68 6
39 45
34 72
16 90
11110101101111111100111111111111110111011011101111101111011011110011111001011111011111101111111111110100111101110a1011011101111110111a11011111111111111011101111
11111111111001111101111111111111110001111111111111011111010111110100111101100122211111010101112112222221221100111a0011011101111101101a01111100001111101111111111
01111111111111111101101111101111111111111111111111111110110110101111111111012101122222110102112121211201210110111a0001111111111011010a11011111111101111101011101
11111111111101100101111111110110111101111111110111111111010101110101111110120212210201022120121100201010001111111a1110111011111011111a11110111011111110111011011
11101101111110111010101100101011111111111101101101111100101111111011010111120100222222110211111122121111011100111a1111011111111111110a11111101111111111111110111
10111111101111110101111111110001111111111111111001111111011111011111100111122110211221120110221012101121221111011a1101111011110111111a01111101111011111101011011
01010111010101101101111111101011001011011101101111111101011011111111110111100112102112002100202222120101111111011a1110111111011011110a01111111111011010100111111
11111011110101111011111101111111111111101101011110111111011110111101101111122112011112001111222011022121021101110a1111111111110111111a11001111010010100100011111
11011101101111111111111111111111111111111011111111111010100101111101011101112220110210011211011220221220111011111a1111111101011101111a11110110011111100110010111
11111111111011011111001111111111111101111011111011110101101111111101111111121001221221122121000122112222201111110a1011001100111111111a10110111111111111111111011
11001011111111111011010101111111110011011111101111111001001111111111111111122100202120111111010221200211120100111a1111011010000111011a11101111111111111100101111
11101111110011111111011111011111111110111111111101111111010111111111111111101022122021211212001022221202121111111a1000100001101111111a11101011101111111101011010
11111111110110111001111011111010111011011111111111110111111100011111111110012012011022221112121221121122211111111a1111101111111111111a10110111110000111111001111
00011111111111111001111110101010111110111110111111111111111011101111101100112211222200020112202021111221021111111a1001111101011011010a01101110101111011001001111
01111111110110111101011111110111111110001111101111111011100001111111000011111200112022011012211122122012001110110a1011110111010111101a11111101010111111111110011
01101101100101111011111111111111111111110111101111101111101111111110111110121221211102010112022201021201201111111a1111110111011111010a01111110110111111111111110
01111001010111110011011111111010111111111101011101101111110111101111111111101211021000212122112021112122211111111a1110111101111110011a11111011111011011111001111
10000110010110111111111011111111100110111111101011110011111101100111111001102100122110012112202112022122211111101a1111111111101111101a11101111011111111110110111
11101111011101111110110001110111011011111111011110110010101111111111111001111212122001221012220102201011111111111a0110111001010112022a10221011112021222202002111
110101110111111111111111111111110101001101111011111111110121222021100221012022222100220221201babbabbaababbaaaaaaaa1110111101110212111b10121222121110102211021110
101111111111101111111111000101101111111100111111101111111002011021121221020022022202221222222a110122222222011111101101110101012012020b10201101122101101122011011
111111101011010101101111010011111111111110001111101101110112210010220201211202222122211221200b212111122120011110101111111101012101001b12021101121202121111111111
111100011111010111111011111101111001101011101111110101111101000202222120121111022222102221220b222111022110111101111101111111011211101a01202221021212000210200011
101111101111011111111011110011101111110101111111011101100002211120110211210222202202221220222b101102100221011011111111111101101000112a01212002222212122120211101
010010101111111110111011111101222020112201222222211200111211112220211011212210101222220220011a111012100122111111111110111111112112111b11120221012211212010212111
111111101111101111011100111011122002102111102021012220112221010222112120100212201022200222212a102102111001101110011111101011111222211a01122112211212121222020110
011111011110011111101010101111111212222212011101112101210022012022012101221220020222222222200a221212121210111100011111011110111122221b02022021010111012110121111
111110111111111111111010001001112211121020101100222221112221020012110211020022120222222202202a212021200022111111011111110111112101221b11011011100022021222011111
111101111101110010110101011111010212222212102121212211122212202021222011112220202002221202210b210012210212101111111101110111102020022a21101100221212022121111101
100111110111110111111010101111101210111222212211020101201200212001202212112222222022022200021b202110222120010111011111011101112112221a21011211121212210212000111
111000110111101111111111011111120002111101221112111211212220212021121001122220202022222121121b012221210101111110110111011111110121201a12221122211211100212012011
110111111111010111011111101111022011012221112111022211210112210112212112220222112202222112011b002122112210110101111111011101110121101b22020121212110021001121101
001110101111111111111101100111102122010201222120112021220010021011222002221222012222221211010a110110111001111110011101111111111111210a21211121212221011212101110
111111111111111010111000011011002022211101100101211021112220202002120010121202110101210211110a101110111110111110111011011100110121111a21022212221101222101122111
101011111111111111111101110110122211220221012122222211100202200002010202120122222220222011110a111111111111110111011101111011112121222b10202120111020211101102111
011111011101101111011011111101222220211211021010102012221221012010102212022221221101210210111a011001100111111101011111010111112111122a12222120220012111211120101
011111111011011101101111111110121221100112221120220001221222221211211001111012112110221211011a101110011110110000110111011111111212002b22002121222222122122222211
111111101011111011111111011101122021212101202221112011211020122221202121202121212221221100111a010111111110111111111011011111111112021b12021010211022220021222111
110111111111111111110111111111220010121101112100222102111220201220011112210020112102122010101a011111111000111111101111111111111000101b11102210202001022210122122
111111111001100111001011101001112022201222211012122211111102211212122110020222001001201110011aaaaaaaaaaaaaaaaaaaaaaaaaaaaaaaaababbabab12020202202121222201222221
0111111101011101001001010111111212111111110111211221211102212122020010210122021121110202101111101111111101111011110111111110110121122222221200210202121212201221
1110111111101001111111111111111222121121211212220112101222001011122102001000122122101102111111111011111011111111110111001100111212222020111112102002120022020022
1111011111111111111111100111110111110221122220220201112222201222102120112010102122121121011111011111010011111111111011111110111211112122020202222011222202220021
1110110101101111111110110111112202210120212122202112222222201101111221212221121020101111011101000111101011101101110101111110111211222201120122020112001122222010
1111110110111111110111010111011221111221212011121121221010222222211122012102102211122100101111011111110101111011011110101111111211102122102211222021222021211000
1111110111111111110101111010112222210200121202111022011122200010221212120011011111220110011101111001011111110011110011111111012021111212002110222112202212012210
1111100111111010011111111111100202022211200012121100221011221122211201211101222002102011111011111111111111100001110111111111112211100221211222221222220202122121
1111110111101111111111110111112010212011111220112121002221122021022101111022101112201111111101211210012201111022102122220221110210022221121020212021212122211010
aaaaaaaaaaaaaaaaaaaaaaaaaaaaaaaaaaabbbaaabbbbaabbbbaabbaabbbabbabaabaabbbabaaaaabbbabbaaaaaababbbaabbaaabbababaababbaaaabbaaaabaabaabaabababaabbbabbaaaabababaab
0010111101111011101011111110112202222110111101122101221022222222121121221100211211210111111100211011210102101120222022220120111001111011111110222102211112122000
1110101111101111111011111011112012112212022211211120202100202111111110111111100110101100111111221211022120112011102110122021111010011111101101021120112222022211
0111111111111011101111111111112201222212212100112221101211021111011100110110111111111001101121212020112022212200112212202221100110111101011100020121122110010020
1111011111111011101111110111110001111011222221101211220211211101111111111110101110110111100121022222011011122101112120112210111111011111111111212212110221210022
1122122122101122220122111111012220222212021101212010120201020111111111010111110101100111111101120221211022222121222101021220111110111011111102121011222211001101
1022122222010021210211101110111200101212002022022100121200012011111101110110011110011001011122102102112022112221011211122021110011111101101112012002202102112111
1002011222111220121102101111110100011111101011011011110011111010110011010111111000011111111022100212122111222121122212011111111111111011001112021111112011112102
0211201212121011121011100111111110011111101010111111110111101111110111111111101111111111110112222021110211110202022222201101011111110111011011111110211110101022
0011220212101002211121111110011111011111011011111111111110111111111111101011111110111011110012112211212021112202111202120120001101111011001112101222121202020110
0110110001202201200002111111111111110001110111101101110111111111111110001111111111101111011122002021211122121021011220021121111011111011111112221211020100111020
bbabbaaaabaaababaabbbbaaaaaaaaaaaaaaaaaaaaaaaaaaaaaaaaaaaaaaa110011111111111111101111101110102201122002102211110101121011021010111110011111112002012202212200122
10220112020100babbbbabaaaaaaaaaaaaaaaaaaaaaaaaaaaaaaaaa11101a111111011110110100111101111111102211221211110121111212021121221111111111111011002121111221222121022
22101021201101a112002111001111111111111110001111110111a11101a111101110111101111111011111111112122210120212100122121201221201000101111110101100111102112100112102
01220120122112a210110211111110111111110111111110011110a11101a111111111101011111110111101110121212120022221122112002201211201100101110111111011201222011222122001
11111110012200a122211111111111101110111101001011011111a11011a011111110101111011011011111110102202111021220220110120211100121011101111110111112212211220122120011
10112121100212b111200001111111110111101110010111111011a11111a111111111011110101011111111111102101221112220111201112101222211111111101111101110111201222112221122
20202101201211b212012101110111111111111111111111000101a11111a011111111011011000110111001000102201121011112122111121102221111111111110111111112110202102220112112
11102111212200a111100011101111111111111101011101111111a10111a101111011111111110111110111101122012011122220212112212110020021011111101111111012112211011211210120
11222210011211a121112010111011111111110111111101011111a11111a100111101011111011101010110111101211022211222121011220122221201111111111111101010111111111011110111
12100222002011a221222101011101111111111011111011111010a11011a101011111011011101111111111111110222220210121020222222111202201011111101011111111000111111110001010
22011222121201a111122011111111111011111011010100011101a11111a101111011001111110110011111110012001222221201202012221000122110111111111110011011101100111011111110
21012000221102b122120101111011100011101111110110111111a01111a101111111101111111001011011101101122210120211212022012001112111111010110111111111111111001111101111
12112220100210a111101201111101111011111101101011111111a11111a101111111110110111011111111101110222221011222112221112012010111100110111111101011111111111111111110
02220211110121b011221201111110110110111011011101101111a11111a111111110111111101111110110011101221211002112021102011111012121011111111111111011110111110111001111
02101111120222b111211111111111111111111011011100011101a11101a111111111011110111111110111101120211111201021112022210102212221111101001111101111111100011111101111
11222210201110a222121111101111111101110111100111101111a10110a111101101011111101111111101001101212202221110222211221012020110111101111011111110011111101101110111
21211220202211b212211111101111011111011100111111010111a11111a011111111111000101111111101111012202122112102212111021212112111111011111101111111101110011111011010
11121102010012a202121210111111111110111010100011100011a10011a111111111110010111111111011111122112211111002122122110222002201111111111101010111111111100110101111
22222212121012a202221011100111111111011100101101111001a11111a011111111101111111111111110111110122221221111221121212212121020101111110111101110110110111111101011
02210222111222b110210110111111111110111101111011001111a00111a011101111111101101011111011101110111111111111111011110111111111111011101110110111111111111111111111
10102211011200a201022200111111011101110111110011110111a11111aaaaaaaaaaaaaaaaaaaaaaaaaaaaaaaaaaaaaaaaaaaaaaaaaaaaaaaaaaaaaaaaaaaaaaaaaaaaaaaaaaaaaaaaaaaaaaaaaaaa
02222021212022a021212011111001111111110111011111011111a111111111111111111111111110111011111111111011111111111001001011111111111110111101110101101101111111110001
22001222012011a121020110001100011011011011111111010100a111101110101111111111000011110110110111111001111110111111111101111111111111111111111011010111011101111111
01010200012211b112201211111111101111111101010111110011a011011111011110100111111011111110111011111111001011101111111111111101111101111110111111110110110111111111
20221210110121b102201111101101011011101101111011111111a011111111111111011110101111011111111011111110111011111111111110111111111101111111001111011111100111110111
01011101111101a111111111011111011011101111111110101111a111011111101111001001000111110111111101111110111110110111110111111100001111011111110111101111111111111000
10111111011111a111101110010111101101110111101111111111a111111011111111111111111111111111011100111011111111011101011111111101111111111111111111111100111111101111
01111111111101a011111111111010101111111011111111111011a110111111101101110101111101110111111010111011111110100111001111111111101000101110111101011001111111011111
11111111110111a101011111000111011101111111110011011110a001111111110110111000101110011001111111111111111110101110111010011111100111111111110011101111110111110111
10110101101111a011101111101011111110000001110111010110a111111111111101111111110011001100111110110011111111101111111111110100100111101101101011011111101011011111
11111111111111a110111111111110101111100111110111011111a011111111111111111111011111111100111101011111101111111111011110111101111110111101111100111111111011111111
11111101101101a101110111111001111111111111101011110111a011101001111101111111011011111000111111101101111110111111110110001111111011111000111111100011110111110111
11101011111111a110110111101111011101111101111111111111a110111111110111011001110111111110111110011110101110011011101111111111110011110111100111110111101111110011
11111111110010a110111111111011001111111111101111101011a111101111111110100011100111110110101202011221122211221220122112121001111110001110111111101110111101111101
11111011101110a010100100111011110011111111011101111111a111001101111011111111111111111011111211021121111122221211110012202211101111011111111110111111111101101110
11111111011010a101111111111101111111111111111111001100a111111100111111110001111100110111111222220202120222122120210101222110011111111101101111111111101111111111
01011111111010a111111101111011011111110111110011111111a011110111011110101000111011110011110212200101021202222122111121012101011111111111011110001111111011000100
11111111111010a011010100011011111111011110111011011101a111111111000111101111101110111101111112202212210221001101200212221101111111011010101010111101100111111111
11111101101111a111111111011100111101101010111011111111a111110011101101101011111011001111110200212111012112102212200201122011111101111111010011111111101111011111
11001000110111a110111111111111111111011110100111110110a101011111111111110111011010110111110010221022112222121211121022021100011111100111111011011000001110011001
10101111110010a111111111111111101111101101111010111111a101100001111111111011111110110011110202221101210012110202220222110011111011100111101111111111111101111111
10111111111011a011010100101010110111100111110111101110aaaaaaaaaaaaaaaaaaaaaaaaaaaaaaaaaaaaabaabbbabaabbbababbbabbaaabababbaaaaaaaaaaaaaaaaaaaaaaaaaaaaaaaaaaaaaa
10101111111111a1111111111001101001011010111101011101111111110100110101111100001101111101111222000021221220210012121010212111110110111011111010111001010111111111
11011111010111a1110111111001111011111101101111111111101101110111011111101111111101111111011102221101112112120011220122110201111011011011111110110010110001000101
11101111111001a0110110011110111101111111111101111010101011101111111111101111111101111111100212212222020122200102222111212111111011111101101111011110111011011011
11110111101111a1101101111111100110111111110111111110001110110100100000111111111111111110101121211201121112122120012201111101011100111011010111111111111111111111
01011111111101a1111111110010000111111111001111110111110011111111111011111011001100111100111211022122121121210100012120221101111101111111111111110101111111011111
10111110111111a1100111101110111111011111111111111011011111111111001111101111110001011101111101021110212110112111122010110010111111000100111111111010011101011011
11111111111110a1011111011111011110111111111111101010101111110011101110111110111101111110111201122000111220120110012120002100111111111111101110110111111111111111
11111001101111a0111101111110110011111000010111111101011011111110101111111011110000111111101112221111200010012121202211121110110111111111111111111111011101111111
10111011111101a0111111011111111110111111011100111100101011111011111111111111111110111111111012021201120202221112222212121210111111111111111111111111011101110011
11011111111101a1111101011110111101111110011111011111011111101111110110111110010001110111111111211101002202110101211121101101111111001011111111110101101111011111
11111111111111a1111111110111011111110101101111101110111111111101110110001110111111011011111201122010222010010201012021112111011101111111111101111111101110111111
11111110101111a0111111111111110100001111011111110111111110111011111010101110011110111111111202112221101021220221210211222211111111101111101111111111100111110011
11111111101111a1101011111011111101111111111111111111111101110011011101111001011001111111001120011110001011122001221012211111010111101101111111001111110110111011
11111101111101a1110110111111111011110111111001110111001110101111111111000110111110111100111111121101011112101210111021122011101111101110011111110010111111111111
01111111111101a1111111111111111111111111111111111011111100100111011010101111110111100101111222122111220221221220111111220011110111101110101111111110111010101111
11111010010101a1111111100110110011101101011111100011110101011011110000101110111011111111101022111221001112020212010211212111110111011111001111001111110011111111
11111101111111a0111101011110100110111111101111111111110011111111011111111111011011110011111111222222221122112200211200021211111100111010100111111111110101111101
11011111111110a1100111111110101101100111111011111111111111111111111101001111010000101111111020221102012011122121001121022211110101111111011110111111001111111111
11111111111101a1001111111011111111111111111110111111011110010110011111011100111110111111010101210121220112101111202110001210110100101011110011111111111011111111
