15 151
14 16
71 150
115 3
44 127
64 147
79 53
58 3
17 24
37 120
11111111111111011001111111010001111110111101111110100010111a1101101111101111111a11011111011110111111011111001101111101111111111111110001111111111011111110111101
11111111111111101110111111011110110001111111111100111011111a0111011101111010000a11111111100111111101111111111110011111110101011100011111111111111111110101100110
01111101112011102121020211022221111222220111011111111101111a0110111111111111110a11111111111111111111101111111011111110111111111111111101111111010011111101111011
10111111120021101022211112021112222112121011101111101111011a1111110011111111010a11111010001101111110111101111101011010111110111110111110111011010110101111001111
11110011111221020010012112220102000112101111110011111101000a0111111011111101111a11110011100111011111111001111111011100101111111110001110111111110111111101011100
10110111122201222122122122021221211211121111111111111111111a1111111111111111111a10101011101111011111111111110111111111011001111111111111110011111111001101011110
11110011102112112011221002011012022202121111110001111111111a1011111111111110111a11111111111111111111111110100101111101111111111111011011110111111111101011000111
11101111111222221120020021211022122122221111111110110111111a0101111111111111111a01111101100001111110100110101001111111011001111110111101110111110111111111110111
10111110011222121101100222000011120021120110111111101110111a0101111001011011101a11111111110111111111101111111110011110111111011011111101011101011111101111101010
10111101001111221101222211112010111122121111111111111100111a1010111110110111001a10111010100111011011011101111111111111110111111100011010111111111111111111110110
01110111122201222112211121200220112210201111111111011010000a0011111111111010111a11001110101110111111111111111111111100111111110110111111111111011011111000111111
01111101120102222011201122021121222002221111111101001111111a1011110111111101111a11111111111001111011111111001100111110111111110111111111100110101111111101111111
11111110112111202202021200110012211221021110011111111111011a1111110011111111100a01111111111111111111111011111111111111101011101111111101111011001111110110110111
00110111101022122212120212200112012211011110011111100111111a1110101111111101111a11111111001111001001110111110101111100100111011011111110001111111111011111101111
01011110121112202120212222020111221112110100110111111111011a1011110111111111111a11011110101011101101111111111111110110111101011101111111101111101110001111110111
01010011000122021202112121120122211111121111011000001111111a1011011101011011010a11111111011111110111011111111111101111111110111010101101110110111111111101111101
11111111122100222222112221222222112110211111111110001100110a1110011101111110011a10110101111111111010111111111111110111111111110101011001111011111100111111011111
11011111122211012011121121220002202101201011111111101101110a1111111111101111111a01111011111111111111101010111111000011111010111110010010011111111101111101111110
11110010120021121211002210120101020221111110111011111111011a1111011111110011111a10111010110111101101101011101101111011011110100111111011111001110111101101111011
01111111101022021212122221212111222111221111111110111101111a1111101111111110111a11111110111111110111111111111111111011101011111101101011111101111111110111011111
11111111121212112111110100102222122121121111101111110011110a1101101111111001111a11011011001111111110101111101011001010111111111110111011101101001101011000111110
11100110122122200210022201111200011112221111111111111101111a1000111111011111111a10111011110011111111111110111101111111111111101111011111110101111111111011111111
01101011112122022220021201101112111222221101011011110100111a1111111111101111111a11011011110111111111111100111111121212221112202112012221001001111111101101111010
00111011011201012102222022120221200002111011111110111111011a1111110101101101011a10111111101100111010110101111112222121112212201122010220111111111111011111111101
11111101121011121221102111201201222021101101111011011111111a1100111011101111111a10111111101111111110010111122010011122212100020102210200100111111010101111101101
11111101122110222220002110001111210222211011111111111101111a0111111100011111010a01111110111110110111110100112212222110212111210221121012111110111111111101110111
11110110100022122010112212220221112202120101111110101101110a0100111010111111110a10110111111111111111111111221221022222212101221101122221111111111111111100110111
11110110111210121122222010011012222112111010111111110101111a1010101101010111111a01010010111011011111011112102122111120022020111121122011111101011111011101011111
11111111122010002102112011022220220212211010111111110010111a1101111001111110111a11010111010110110111010111111111220222121210210122222112111111111111110101110111
11010111102222002212112102110122211201121000111100111111111a1110111001111111101a10111111011101111111111112112111022000011201220202222222100122211100110111111110
11101111121022121001211101102102122221121110111111111010111a1110001111011111101a11111111111111111111011011112012022022212020222122222202110012211111101111001101
11111011101020201122200122012100112120021101101110111110111a1011010011111100111a11111011111111011111110001100222102222012120220222221010111121211111101111111111
01011111112222200112222001111211121112101111111110111111110a0111111111110111111a00111111111110110101111111111021212201120222222220010021021210211101111111011110
11110011111110111101000111110001111111111111111011111110101a0110111111001111110a11101111001111101111aaaaaaaabaabbbbbabbbbbbbbbabbabbaabbbaaabbbaaaaaaaaaaaaaaaaa
10111111110111011111110011110111001111111111011111011101001a0111011111111101101a11111111111101011111a11110011012221200020222222112201210111222200100111111110101
00111111101111111111001111111110110101001001001101111101100a0110110111101101111a11111011110011111110a11010211201202112221222202210222200120021110111001111110010
11111110110111111110011111100010110111111001111110111011011a1111110110111111111a11111101011111110111a11011112012220022210220102210001121201111101111111111111111
11011111111111011110111011101110101111111110011111111111110a1010111010111111101a11001111111011110011a11110111202021202220222022202011200222200011001110111010111
10000110111110011100011011111111010100100001111111101111101a1111111111111110111a01111111111001111111a11110211211201222220021122022222210121012111111111111111111
01100111110101111111100110111111110110111111011111100111111a1011011111110011111a11110111111111110101a11112112010221202022012202101220211121110211101111100111111
11111111111110011111011111111111111101111111111101111010101a1101111111110111110a11111111111111111111a10111200101220221022212212022221212111211210011000101110111
01011111111111111111111101011111110111101011111101111110110a1011111101010111111a00010110110111110100a00102011021021220212201022022222000212110211111001101011011
11011111100110101111011111111111111111111100101101111111111a1110100101111101010a01011110001111101101a11101012221212202202202202222202022210112011101111010110111
01222121010210110211111011011110111111011111111111101111110a1001100011111101111a11110111110111101011a01100220111212022221211121221222022011101211101101110110110
12112202202002111111110111111010011011111111111111011111111a0111111111110111111a01101111111111111011a11111111111202221210222221202221222220021211111011111111111
21121111220212021220111111111101110111001110101111111101111a0111111111101011110a10101111111111010111a11101121121221011202211112220202211122020110111110110011111
10211112200222221221111100011011011111111101101101110111111a1111111111011101111a11111101111111111110a11101222221202221111112121022220202210022011111111111011011
22121012222221022211011111111111111111101111100011101111010a1111011101111111111a11011111111010111011a11112212110202002022110022022202002001112011111111111111011
22200010112120112201110110110111111111010001110111110100111a1011110100111011110a11111100111111100111a11001001112212222222120022011022202211211111111010011111011
22122012002212210020011001010111111101111101111000111111111a1111101110101111111a10111110011001101101a11012111220220022010201222020222122202120021122110222122022
10121122221211210120011110111011011111111111111111111111111a1111111111111011011a11111101111110111111a10112012220220122102220022112222222202011221212222122121112
12122200211120121211101101111011111111110110110010111110111a1110111111110011011a11111111101110110111a11101021211220020221210122220222221222222212211220112202110
22211111112120011200111111011111100001101111011111111110011a0110101001111111001a11011111111111011101a01101112211222201012221012122202002122221222111110011020010
20211201121121100211111100110111111110110101111110111010111a0111110111111011111a10111110111111101111aaaaaaaaaaaabbbabaabaaababaaaaabbbabbbbbaabbaabaabbbabbaaaab
01121112121222021121011000001111101111111110111111011110111a1111011111111111101a11111111111111111011111110110111011210202022121121202222001020122112111101110121
22212120212112102011101111111111111111111111100111011111110a1111011111111110111a01111110111110011110011000111111122100101002010121100102012111101110211010002100
12211011011212212211101110111111111110101011111111111111110a1101111010010111111a11111111111111011111111111111111111121122011120111102222221220220022222021202202
12221211221121212011110110111111111111110011111110000101111a1011111101101001111a10011110111111111111111011111011222222020122221211002100111112222121202222202211
02211112022111011200101101111110111111101111111111111111111a0111101110111101111a10111001111111111111111111011111102011210111210100111212202220001122201222222220
22221021111202111011011101011101110010011111001111111011111aaaaaaaaaaaaaaaaaaaaa00110111110111011001101111110111012212120101111112222222202221012022020200222022
bbaabbbaaaaaababaaaaaaaaaaaaaaaaaaaaaaaa110111111110111101111101111001111111010111111011101100111111111111111111111011110000111111011212202021101221212221222102
222211211222122211001111001111111001111a011111111100111111111111111101101111011101111110111101111100111111111111111111111011101111112112122120222222012202111222
112112212202122100201111011111111101101a110111111111101111110100101011101111111110111111101011110011111110101100110111101100100011111100121000022012220010222121
201000022121002222211111111001111001111a001110110011100111111111101110111111111111111111111101111110011111110111111110111111111101102001222120201022210212222101
202121121120120122201011111111101111112b222212022211211202111122111101011111110111110111110111111101011111101111011101101111111011112122202001222222220021222022
122100001021021222101101101011111110011b222220212220102022020211021001111011111110110111111111011110111110111110001001110111111111112022222111012112202220200222
022202001210111211111111111111111011110a212021210210111201012101020121101101101111110111110111111101111111101111010110111111111111112010110001022022222021222222
012112201021102221210111100111110111112a222210010120011220021012020101111010111011011111010111111111111111111100101011101111110111111212220222112102122222221210
111101202212001211211111001101111111110a102210212022122202020221111011111111111111111011110111100111111010101111111100110110111111012212120222211001120220222000
121110221101222221111011101111111101101a012222022102201000112101221101101111110101100011101111111111101001111110011101111111101111102212222122222222221102002222
210002002221101020010111111111010110111a111011111212212112211021212221111110110011111100111100111110111111111011011101010101111100102212120020100210022012020001
110012200102200200001111001110001001111b221102111212222021222110221201111101001101101110110011101100111100111101111101011111111101112212221122122202222212202100
010120112212101221211111110000011111111a01202201012221002211abbabbbbbaaaaaaaaaaaaaaaaaaaaaaaaaaaaaaaaaaaaaaaaaaaaaaaaaaaaaaaaaaaaaaabbaababbbbbbbbbbbbbbbbbbbabb
211120102222211221201111111111011111100b02212122202222101020a022012201111111110111110011111101111111111111111111111111001111111111112110222201212222122212102002
010011111101101111111101101010010111102b21222110120110002111a120202011111111110111100110101011101110111111111101111011111111111101111012102201222022122222122212
101111111101011110110101101100101111102b22111202021121101200a222202121111011101011111011111101101101100111111011111111101111111111011122222222221220011212122122
011101101101011011111110110010111010112b20010210120201122111a212011121111110110111100111011111111111111111110011111111111011111110112012222222102221212022212022
111111101100111111110110011110011111112b22021211212012211101b222201210101111111110111111111111000010111011111011011101111111011101111211102212210222222220022221
111010110111011010110111101111111110112a21222212222210020121a222102221110110100111110011111011111111101001111111111111010011111111011202202112221210221202022220
010111100111011101111101110111111110112a20212121222111101001b002122121011110111111110110010010111110111010111010111111111011101111011212202111221222012220202220
111101111110100101101010100101111101101b01101122221212212220b201212111001111111110110101101111111101011011011111011111011011100111111102022101212211111102000210
101110011111111011111111101111111011100b12101002222210110111b111121001011111011111011111111110100011110111011101111001101111111111111112212011001201201201202022
001111111111110111111111111101111111111b11012100220121202222b200002020111011101011011111111111111101101111111110011111111111111001111111112022012012012001212121
111111111011011111111111001111111111110a22022222010212202212b022020110111001010111111111111011110100111101000111111101111101111111111110022111111202122121112220
111110111111111111110101011010001101112b11102122101212102112a120011121011111111111101111111111111111011011111011110001100111111111011101211111122121112112212002
110111101111110011111110001111111101111a12201112112101222022a112212011111011010111111111111111101110111101110111111011111011111011001112121212121221022221200011
111011111111010111111110011111110111010b21211102222001120101b211221121111111111011111101111000111111101011111111010111100111101111011010102121221120222221221211
101111111000100110010111111111111001111a22201200212011111212b001122121110101110010101111111111111110100111110111111011011111101101111011011001111010111111111110
110110010111101111111111101111110111010a00210021121212212222a210212011101111001111111111011010111111111111111111101111111110011111100111011111001011111111111101
001110111011110110101110101001011110111b22212221012122212112a112211221111111101110111011101110101111111110111011111110111010110101111011010101111111111110110111
101101111111110001111111011110111111002a22210101220002222202a222102121111001101111011111101111111011101111110111111101111111110111111111111101111110101011011101
101110111111101011101111110111111110112b12221012121112122012a111022021111101101101011111111100011111110111111111111111111110101110111111111101110111011000001100
111110111111111111111111101111111101111a01220112121022120212b202122111101011111110111101100101110111111111111101010111111011111110011110111111111110111100010111
100111111111011101111111010011110010010b21112111212111021112a022220120111110101110100111011110100111011111111101010111011101111011111111001111101101111111111101
111010111101011111101111100111011111101a11100112100112210102a002222111110101101101011111110011111101111111111010110111111111011101111110111100111010111111111111
110111101101110111111111011111111011111a11111110111011111110a111111111011111111101011111011111111110101110110011110001011110111011111111111111100010110111111111
111110101011101111111110111011111101110a10111101101011111110a111111010111111111011111111110011111001101111000111111001101011111101011110111101110110111111111111
110011110110011111111010111011111111000a11111111111111110001a111111001111111011111111110111111111100011110011100110011111110011010111111111110011111111101111101
111101111011101001111111110101011111110a10111111001111110110a110111111110110110101111111101101100011011111110011101110101111111110101101111101111011111111101001
011101111101011101110111111110110111111a11111001101110111101a110111111101101011111011011101111101110011111111110101110111111101111101111111111111111111111111100
221112200221111222111111111110111100110a11111110100111100101a011111101111011111111111101101111010110111111111101111011111111111111011010110111111111101011111101
212210220211222122011111100111011101111a01111111111001111101a011111111111111111111001111011110011111111111111111111011111101101111111010111111011111111111001010
010121022100202110211101101111101111111a11101111111111101110a111110111001011010101111001011101111001111111001111111101110111111111111111101111111111111110011111
121001221122111021111101111011111111111a11011110111111111101a111101110111110101111101111011111011110101110111010101011111101110001100111111111011101111011010001
220012122212102110111111111111111101001a10111101101011111110a111100101111111110111101011011110111111110111111111111101101011111111110101111101101110111101111100
220022111120102012111111111111011111111a00111111011111110011a111111111111111111111001011001111111110101111101111110111111110111101111011001111111011011111110010
211112000202101022211011111111111110010a11111101111101111111a111111011110000111111110110101101111011111101111110111100111111111111111111011011001011101111111100
202210222020111121211111111110111110101a11111101011011110110a111111111110110111111111111110011111101111101110110111101111111011101111111011010101111111111010111
110110121011110101111101111111001011111a11011101011010101111a111011110010111011011001001011100111010110111111111111111100111101111101111101111110110111111100011
002101102221010221011111111111010101011a11110110111111110110a101111111111111110111100111111110111111110101001101101110111100010011111101111111110010111011001001
112012121210102021111001111111101111111a10101111111011011111a101111111111111011101011111011110101111011101111111111101110111110011111110010111101111111101110111
111211201202011112211010101111011111111a00111001101111111111a111111111001111111001111110111111011110111111111111101111111101110101111111001111101111111111101111
121222220201111221111111111111110011111a11011110110110111111a111111111111110110101011111111111011111011111110110001111111111111110110111111011011111110111111111
112102210201221021211101011101110100011a11111111111111111110a111111011101010111111011111111101111100011101111111110011100011011011011011111100110011111111111111
212212111211102101011111111011011111111a00111111110111101011a010111111011110101010001110111111111011111011111101100110111101011011011111111111101111111001111111
112101012201112220011111111111011101011a11101101110111111110a110111111101101111111111011010001110110011110110111011101111111110111101011111111011110111111110111
021110010010121200111000101010010111011a01111110111110111111a011111111011111111111111111111111111001111111100111100111010111111111110011100111111111111110111111
111122102112021020111110011110111011111a01101011110111110111a110111111111100011011111111111111111100010111110111110111111111101010100111111111111111011111111110
000222020211110201010101111011111011111a01111110101011101011a010110111101111111011111111010111111110111111010111111101010110100111111011111110011111111110111111
110222002111222102111111100111110110110a11111000111001111111a111110111101111011111111011111111101110111011110111110111111110011011100111110101110110110110100111
