117 48
8 158
30 80
77 48
32 104
57 71
75 13
97 33
89 77
25 149
1111111101011111110a111111110001111100111111111111111111110011000011111111111001100010111111111110010111101a101110111111101010111a101110011011111101110a01111111
1111001111100111101a111101111011011111110111110001111111111101111111110011011111011111111111111110101111011a101111111111011111110a111111110101111010111a00011101
0111111111111011011a111011101000101110110111111111111111111111110111011111111110110101101111010110011110001a111101011111101111001a100011111111111111111a11100011
1011100111010101111a111110101111111101101010111110111011111101011111110001110111110111010101110110101111111a101011110111111101111a111101111111011111011a11011101
0111011011001111111a111101110111100011111011000111111111110111110001111111111111001011011101111111011111111a110111011111010111111a110111110011001111111a11111001
1110110101111111101a111111111100011111111111111011111010111110111111011111111011110011101110111111011110110a111111111111101010100a111111111111101101111a01111101
1110011111111011111a110111010010110001111110111111111111000111111011111101111011101101011111111001111111010a111111111111101010100a101110011111101111110a11110110
0011011011111011111a011111110111111110111111111001111011111101110111011111111101101111111011111111110010111a111111110000111110111a011011110001110111011a11101101
0110100100111010110a100111110101011011001011110110111111001011001111110011111111011111110011111111101111111a111111110111111011111a111110111111111101110a11111111
1011111101111011011a011110100111111111000111111111011111111111111111111111011011011101111110111111010000111a011101110010001110111a010111011111110010101a11111111
1111000011111011100a111111111101110011101111011111011011111011111111111110010111101111111011111111011011111a111101100111110111111a111121222121202211112b11020121
1101101111111111100aaaaaaaaaaaaaaaaaaaaa1111101111101011110111111101111111111111011011100111111111111110111a101111111011011111010a111121221012221111102a01122220
111111111110111111101111110111111111101a1111111111110111101011110111111110101111011111011101111111100010111a111000111111011110011a111100121212212111200a22120011
111111111111111111111101110110110111111a0111010110111111010111111101111111111111111111111111110111101111011a111001111111111101111a111022112201112121120b11202210
110111111111011111111010110101110101111a0111111111101011100101111010111100011110111011001111011100111111111a110011111010110001111a111111211222212211112a21011020
111011010110111111110011111101111100110a1111111110011111101101011012122022101010211212121112111211110100100a111000001101111101001a101100100112121112111b12112212
111111111011111111110111110101011111110a1010001111111011111011110110112112021021011120011110111210111111001a011101111110111011011a011111221221222221000b21010122
111111011101110110111011111111111111011a1111111111011010101101101120212110202022021111221002122020120112202a212201011102010111111a110121212211201021210b11110200
111111111111111111111111111110111111111a1011111011110101110110110212002200101222112012112122221210111121202a201120122101000011111a111111211001212222121a12122222
101011111111011111100110011111101111111a1111100110111111111100111001212121221212112211021212102011011010120a022221020022111111111a110120102110020221121a22222222
111111010110011111111111111101111101111a0111110111111001111111111202112202221112112110110221222111122000002b221102202010101111010a111120120212112212022a10222202
111111111111101111111011110111111101111a0011101110110111110101110012022120212010112211122222212021121120122a222221121112000111111a111101211021122112122b22202021
111111111001111101000111111111011001011a1101111111111110111111111111111222211121221221112220212201111112220a202111212220100101111a111111112212220201122a20121021
010110011110111101010111011111110111011a1111111111111111101111110002100221121122202112112222212012010210212b212120100201110111111a111122122221101111201b02120111
111111111110111110111111011111111001110a1111111111110110111111100111201210222112022021122202212211122111220b001102121221111111110a011102212020121221221b11222121
011111011011101110001111111111010111111a1110111111101111110111101222212120211201011212011212121022211012211a212202022012110110101a111102211011100111122a12222102
111111110111110111111111110101111010101a0111111111011010111111011110222012122012221222011010222202121210112b211210201211111110011a111110222210120222121a10012122
111111101011111111011111110111100011110a0011011010111110111111111210011122122111202110111102222212200222202a110002202001110111011a111112011100212212122a02201201
111111111111111111011101111111010110100a1111111111110000110011001011112002212121222012101220222112101122222b222202201201110111111a100010102111010110120a11222212
111111111110111111101111111011010111111a1110111111111111111111111222211100200120022211201100100220202022102b212222112111110011101a111111011100222211022b12222000
011111111111111101101111111111111111111a1101111111111111110111010212120221111222101120112221222221212112212b012120222110111110111a111122122211110022122a22221122
011001011101111111111001101111110111101a1111010101111110111111100202112210211110021222011201122002121221111b222021101112111111011a111110121012021200011a12112121
101100011010111111111111011111111111110a1101101111111111111111111120101112221222102201211002122110211120210b222111120221111111100a110022211201022010222b22112211
111111101100101111101001111111111111110a1101110111011111111100111111221222210121211211001022121100202212112a012102120222110111111a101120020102101020212a12012102
111111110111111111111111111111101111111a1111011011011110111111100122121212221210112212222220121200022102221b222201211210001111101a111112212101201022022a22211101
111110111111011111100111101111111110011a1111110111011111111110101221221002112201220021012022201021212012100a100022220121111111111a111120002200111212020a21211021
110111110111111110011110111111111111111a1111111111100111111011111112012121111110122212122222222022102111011a212022220220111111111a111011021110101111112b02112220
011110111110010111111110011111111111110a1101110111011111111111111112122210212011021112202121121112220221111a111012011110101111101a111120200100121111222b10022221
111111111101100111010111110110110111101a1111111110111111111111101111212010202121110212211202022211120022011a111012001000101011001a111101212212201112012b12120001
100111011101111111011101011111111011111a1010100101110010111001111212200001210211221001122221122212212220011b110000111202101111111a111120212222202221101a01020101
111111001111111111110101101111110101111a1111111011111101011111111112222010220112201020021000022021111120022b111220221122111111110a001120222021011112112a21021021
111101111101110011111111101111111100011a1111010011111100111111011001010121012001120201222210100220111221101a220021012211000001011a111111111101111111001a10111011
111110110110111111111111101010111110011a1111111101111111110021202222021200022020221220221222120021121020211a121101122111011111100a101110111101111111111a01111111
111111111110111111111110001101111101011a1111111011110111210220021221012120220220202212221220122012102121212b111012111210111101111a111111111011111111010a11111111
011110101011111101001010111110111110111a1111111111111111222211110200222011220020222221211222221022101121110b222022112101111101111a101111110111110110101a10011101
111101111011111111110011111101110011111a1010110001001101111202102022112222021122212102112022022012022222201a212202222010111111011a111111111111110111111a11111111
111111111011110111111111100010111011111a1111111110111001221012121212211121211121021211211010211212010122100b212102120201101101111a101001110110000111110a11111110
011111011111111001100111111111001111010a0111111101011111011012112211101211121102222021011212011102221110201b201002111212111111011a111111011111111111111a11101011
111111110101010011101111111110101111111a0011111111011111011121022120210201222220210120111010111011111111111a111111111111111111111a011101111100111100111a11100101
101111011110110111010000111111011001110a1111111111111101122002212122000111120202001222101111101011101111010a110111101111111111011a101111111111001111100a11111111
111111111110011101111101111110111111010a0101010111111001111112100111221221120212221020211011111101011100101a111111111111111110111a111111111111101110110a00111111
aaaaaaaaaaaaaaaaaaaaaaaaaaaaaaaaaaaaaaaa1111011100111110211222112222212221212212222112111101111010111111111a111011111101011100110a111101111011100111101a01011011
11101111011011101111110111110111111101101100101011111111110121010121210221121200122222210111010110111011111a100011110111111111111a110111111111001111101a11110011
11010111110110011011100111001111001100011110111001111111021101121021101101202112100022111110111011101110101a111011111111111101011a111110110011010111111a11111111
01111111101111111111011011111011101101011111100111111111110211211122121021122022110102011111110110001100001a001111100111111110111a011111111111110101111a11111101
01001111111001111110111011111100110110110111111101110111101122220201222120211210121122111101111110101111101a111101110110111011010a111110111111111011101a11010111
01110100100101011111101101110111101101111110111111111110002012211221122212010110001011100011111111111111111a111101101011111011111a111101111001110011011a11110011
10101011110110111011011111111111101111111101010111111110211210122101102211102111022120211101101111111111111a001010101001010011011a011101111111100011101a11111111
11110110111011110001111001111111011111111111011100111101211220122021121112022221222021010111011011011101011a100111110111101111111a111111100110011011101a11101110
aaaaaaaaaaaaaaaaaaaaaaaaaaaaaaaaaaaaaaaaaaaaaaaaaaaaaaaabbaabaaabaaa221022110222212200200101111111111101111a111011111100100101111a111111011010111111110a01011101
2201200122121221211012102212211110111111111000111011101011211022212a122112122201021210101110101011011111011a010111101111111111101a111101001010111101111a11101110
2210112120021121012011200101111110101111100101011101001100102122220b012212211022102101101111011001101101011a011011111111111011110a011000111000101011111a11111011
0102120222111112011121102211110112122021202212222110212210122100112a022111200220112120011111111111111111011a111110111110110111111a111111111110111011111a01110011
2201222112102220112210112221211111111222101122112000111122202212221a212212201221012110111111111011111101110a111111000011011100111a101111011111011011011a10101001
2122002112121220211212011201111111212222212222201101121010021212222b000121220222110202111111111111111111111a100111110111111100111a111110011110111011111a11101111
0112121101122102012022221221011111022022011222022001012122121022112b212112121110211111210111111011110001010a111111101011111101011a110110010111110111101a11111011
2121002201221000210212120211111111201220112202111111201222101022111b210121212011122102201001111011010110111a111110110101111010111a001110101110111011111a11101111
2201122022222000222122110022110112221212122112100100220212221022222b000222112212202222001110111101110101111a111101010111011101101a110011111111111101011a00110001
1220101021211101202101111211211000111011211200010022121221222122102b111111212210122002211111111111011010101a101111111111011111110a101101011111111111011a01011101
1122221121221202221201011222110012222211112212221221110212222222021b210211022021122111111101111111111110111a101101111001111110011a111111111001110111110a11110010
2212121021122001102221211000211111020122220121101211102102222001120b121112121201121111201101010011010111010a110101110111110110001a011000110011101100111a11111111
2122201211212011221100120111211012112112122121212011210222020212012b211221212212021001200011111000110011111a110110111010111111111a111100101011111111111a11011101
0202120110112221122122100111111110102022220222222011211222021222111b112111101011211112100011101111101101000a101111101111010110110a100011011010011101110a01111111
2021121022222222200200100122210112211222210021110020211002121111001a111111110110101111111110010111111111001a111111111101111110101a111110111111101111100a11011110
2220220122211101211022210110101102122012002122002210221011212222112a000021011210022112021101001100101111101a111101111011100111100a001110111111111101111a10111101
0110012221221202211202100120211012012020021211121020001012111220012a202100101112021101110102111110111101000a011111111111111011111a111100111111111001101a11111011
1112212221221121202110011202010012200011121111221212021210222222212a010111121222121212222012210111111111110a001011011111011011010a111011111101111001111a10111111
2210212210101121211222122202211111212120120012011111202211112022001b211122000222201221222122211101101111110a111111111011111010111a101111110111111111111a11110111
1020200212112210100111200221211002122210121112020012120111100102122a001001121022012220210222111101111111111a111111011111111111110a101111110010010111111a11111010
0211011120011011011012112120100112112122111222211201112110222221020aaabaabbaabbbaaabaabbaabbbaaaaaaaaaaaaaaa111110110111111101101a100111011011001111111a11111111
022212101012122101200011022111110011211201101220111201211221112112212101022011222221222122012000111101110110111110001011111010011a110000111111011110101a11011101
110021220021221210222101201200101210221001211222102202021210102210221112211201122222121200122111111111110111011111111111111101011a011101111111011111111a01110111
222000211122221102102212201222022210212222122222001022212221012012201111002222111222122222010001111101111101111010101111111110111a111000101111011111100a10010111
112212211212212120220201220122220212022222002202220101211120212001220222101212111102221112222111100110111111111111111111111110111a111111110111110111010a11111110
202110010011020111200002021221120012211102222100111112111210222012221222111202212111020112211111111111111011110111110111111101111a101111000111101001101a10111111
010222222121211111102220022112022212122102222110210102001110122201021111221110222122202011021011011111010011111111110111111111111a111111111101111011111a11001111
112011222102011022112210112212201202220202112210221112021012221202120211211220012111212022222111111110011111110111111111110100011a001111111110111111111a10111001
221101222222221221200212212210222022210101101022011112102011222120101021222210211011101111101111111111111110111111011100111111111a101111011110111111011a11101111
121012022112122021202122000211222121122212212221010002211112210222101111100211111120212211111111010111111111111111111101011011111a111110011100011111110a11110111
221000001122212222211020022220102222002211011001022112112211221120111120110221110111100222121110011111011110110010111111111111101a101111001111111011111a11111001
102111222220212210220202002221201022222200221222210211201211012100110220211001021012221121012111111111111011101101111011111111111a110111111111111111111a11010101
111000100111111111220002212211101200122102221122211012200212211101011111222122222212122122221111110111111111101101111100101111110a110001101111100111111a11111111
111011011111101101012112111212221220202221222222021202220122221200212211022110201112222202101101110111111011011111111001101111000a111110110111011110101a10111111
010111111011111101011102022212111221120211222101100111111101102122011020222121111101201211201111101010100111111011101100110001111a111110111011101111110a11110111
111100101111010111212212212221220221100220110100211110111111112112012011222000211112220122112010101111011100110011111110110111111a111111111111111011111a00000011
111110110001111111121010122202120212122201201121101101011011112211220121222202120202102122000111111111011011111111010011011011111a111110111101111111110a11111111
110111101101111101111121012120221121021220201221201111111011012222120212121101221000021112221111111111111011101111110011111110111a111001111011110011100a01111111
100101101111110111122211221210000101201210221120211111111111012010111010020201000011110111222111111111111011111111111110111011111a111111111111101111111a01010111
111011110111111110211202212111022110022211001220111101111011111101221112202211001211201102012111111111011011111111111111011111111a111011011011010100111a11111111
101111101001111011121110122212121020210222120011211111101111011122101201212211222021012020120100111111011010011111111001111111111a111111011101111111111a11101011
111111111110010011112002012212211111110122200201211111111011102201022aabbaabbaabaabbabbbaabbaaaaaaaaaaaaaaaaaaaaaaaaaaaaaaaaaaaaaa101111111111110111100a01100101
110111011110111110001111010120122020221222111011111111111101102222011a212021022210021110221200111010111010111111111001111011010111111111110111111111110a11101111
011110111111011111202221101112221012112101022212211110011011111201121a101001201112202122122220111110010110111011111111011001111111111101100101110111110a11011111
011111110111101111211222212210211221122111002112210110111111112010112b100121010210111112121201011111111111111010011111111110101111111111010111101111011a11111101
111000111100111111021101211121220200012001221021201111111100011101212a201201111220110002210201111111111111111111111110111111011001110011111011110101111a11011100
110111110101101001112200221222111221022020121021011111011110111111111a110111000111111111111111111111110111110011000111111111111111111101101100111111111a11111111
010111111110111111110221121010112122222101121111211111111110011011111a111111111101101110111111011111111111111111011111111111101111101110101101111011110a11011101
110110111110011011002220210120012002122212211211201111111011101011011a101101111101111000111111101111110110110111111101111110011111011111101000101111001a11011111
010111110110101111211011221100201021011220200211110101001101011111111a111011110101011111110011011110011011111111110111111111111101111110011110110111111a01011111
001101111111101111221212122111120110222210121022211011111111110111111a110011000001111111111101000111110111101110001011010111101111110111111111111101011a01101011
111100111111010011210211102220111212120121101202010111101111111111111a011111001111111001111010111011011111101111100110101001111100111010111111111111111a11111111
111110100111111100111122102121112101222211220111111111111111101111111a001101111111011101001111111011111111101101010111111110110111111110110011111110111a11111101
111111111001111110221212101222111222220222122121201011101100011101111a111101111111110111111011011111110111111110111111110111111110101111111011111011001a01110011
111110111111111101101111001111111111101111110101111111110011101101111a010101111111111101111111111100011011111111101001111110111111111110111110111001001a11100111
111111001101001111011111011011101111111011111111111000111101011111110a101111010111101111011111000111110101111011111111111110111111111111011111011111111a01101100
010001110111010110111011111111101111001100111010011111011111111111111a011111110101001110101110111110111110111111111010111111110111101101111010110010111a10111101
111011111111111111011111110101111111111011111111101010111111111111101a111111111111111110110111111011101110111111111010111010111111111010110111111111111a11111111
011111011111011101011111110111011111011111011101111111011110110011111a111111111101111111111111110110111111010111111110111111011110111111000011101100111a11111111
011100111111001110111011111111111101101111111101111111111010111111101a010111011111110111111010011111111111011111010101100100011111110111010111100111110a11111110
111111010110111111111010111111110011101111101111111110111001011111111a111101111111110110110111101111111111111111011111101111010111111110111111111111111a11111101
