71 154
93 3
52 114
32 66
56 77
1 156
69 116
52 123
36 79
93 108
011111001100111101000100101101010101110111111110111a11111111111111111101111111011011111101011111010111011111111011111111101011a111111001110011212210112022111112
010101111111011011111010010111110111111110111111110a11111111100010011111011011110111010111011111111111111111111111111111001111a111111111111111221221222211111122
101111101011101100110111111011011110110111111111110a11111101111111011010101111001101111111111110101110111111111111111111001010a111111011111112111022220220120221
111111111111111111010101111111111101101111111111010a11011101111111110011101110101100111111111110011111111111111111011110011111a111111010101111012112021121220111
010111111101011111111111111111011011111011101111011a01111110111111111111111111000111111111111111101111111111111101011011111011a111111111011111100121112211112112
111111011111111010111010111111111011111111111110111a10111011111111101001111111110111111011011111111111111001111111111001111101a010111011100112100202102220012012
111111100110111111111110101111110111111110000111111a11111111111111101111111111111111111100011110111110111111111111101111001110a111101111111112110212112122101212
011011011111111110111011011110111011101111111111011a11111111110111111111111101111111100111011011001111111111111101111111110011a011101111111012112211120222201211
111111111011111101101111111011101111111111011111111a11111111110111111111111101011011100101110010011100110101111111101101101111a111111111011102110221121111101221
111111111111111111101111110101011111111111111111101a10111011001010111011110010111110111101111111010111110101111110111100111011a011011001110111222121121021022212
111001111011010011111011111111010111110011111101011a11111111101111101110111111110011111010011110000111111111111100111110111111a111101111011111111101220111021110
111011111111100111111110111011111111010111111110011a10011100100110111111111111110011111111111111111110111111011011111101111110a011110101111102122112201012110010
111110111111111011100011110011011100111010111111111a11111101111111101111101111111111111111111111111111111110110111010101011111a011100111111112222120102201211002
110101011101111110111111011011010111110001111111011a11011011011010001111011101111011111100110111111110111111111111110011111111a111100111111111100211002022111212
110100101100101111100111111110111111111101111111101a11110111100000011101110111111111111111001110111110111011101111110111111111a011111111111110122111211110201210
010111110110111111111110011011100001011111111011111a11101011111111101111111011111011101101111010110100101111110111011011101111a111111101111012122222220200212122
111101111111110111111101011111111111111100100111111a01101011101010111100111011110111011011011111111111111111011000101001111011a111111010111012011121020220221111
110010110011111111111111111011011111111001101101111a02211202220200022022102011222111011111110111111110011111111111110011111111a010010101011111011110001100110111
011111101001101111111011011111110111111011111111111b11102110221212102122110202122111001111111010011111101110011000101111011111a111001101011111111111111111111111
110111110111011111101011110101110011111111111111111a12011012022202012222102101012111111111111011110111110111111110111111111111a101111110111111111111111111010111
111001111111111111111101111101110111111011111110111b2020020001111211101121121020011111aaaaaaaaaaaaaaaaaaaaaaaaaaaaaaaaaaaaaaaaa011110111111101111111111001110011
110111111011111111110111011101101111101011101110111b0020221101022202220222001220202000a1120201001111011111101111111010101101111111110011110111101111111110111111
111111111011101111111110111111110111111010001110111b2120122122112122120122222220021122a2201221100111101111011101011111111110111111100010011111011111110111101101
110100011111111111101101011110111111111111111111101b1221001122022222202212221022000211b2202202211011011011111111110011111110111101111111111111111111111110111110
111111111111110011111101111111011110111111111111110b0111102121202212010121222122222221b1111210111111011110011010111111101001111111110101110111110111111110101110
101111101010011110111111111111111111101100101100101a2222222222012222221000111110022111b1010112211111110111011111010011101101011111111111111101111111011111111111
110110011110110111111101111111111110111110111111111b1112100021102021120222221220222222b2111101211111100011111111010111110011111111111101110111101111011111111011
111111111111111110011011110111111011111111111110011b0120102211002222220221122221220110b1220220011011111110011111110111111110111111110111111011011101010111011111
111111111111111011111010111110110101111101101111101b2212112021222222100220222020201020a2111211211111111011101111011101111111101111111101101101111111111111101111
111111111111111010110101110111011101111011110111111a2011221022102012101222212222222111b0012222211011011111111111111111111101111001111101011111111111111011111111
110100011011111111111110111111111111101101111111111b1112122121112212220122010222021122b1222111210111011011011111011111100111010111110111101011111111101101111111
111011111111111111111011111111111111101100111011111a2212212221122212200122212221111222b1201021201111111011011111111110101111010110111011111111111111101111011101
111101110100111110111011111110101111111111001011111a2120111202011222221001211122202002a2221222111111110111101111100111111111110101111011001110111010011011111111
111011110001111111111011011101011111101101111011111b0011211200100002011212012222022212a0021011111110111111110010111101111111111111010101111111111111001111011101
111111011111101100011111010010111111111011111110101b0221111112012011202221022212101121b1122221001111110111111111011111111111111111111111100010111101111110111010
111111101111111111111110011111111101110111111011111b2010112021210002222220220222222110a0220011001110111111011110011110111111110011111111111111111111101111111111
100101111111111111101110111111111110011011111111111a2021221022212222022202221222020110b1012111211110110111111100111101011111111111111001110001101111111011111110
110111110111110101111011111111111111101111111110011a1122121220111022122211212212222102a02101222111020220001010021222221202022020020101112211aaaaaaaaaaaaaaaaaaaa
111110111111111101110111010011110011111110011101011b0121010122110112011222110222212101b21221212111121221211121112212222220022122202121111111a1111111111111100111
1111110111101101011110110111111aaaaaaaaaaaaaaaaaaaaa1221122012212202212022022222212022b11202221111121011200212202211222222222022200221111220a1111101111111001101
aaaaaaaaaaaaaaaaaaaaaaa00111110a111111100111111110110100102110212022212202220222222221a21011021110111120021222122022002222022222101020210201a1011111111011011111
1111110111101101111110a11111111a111011111111101101121102112010011220202220222222022220a21202210111122111110212121212212212220222111112200201a0111111010101100111
0110111111111010110111a11010111a100111111111001110011121212100202202020222222220221202a22222121110122221120122221212222212202202200121002220a1111101111011110111
0001111111111101111101a10111011a011101101111101111102021211122222222202022222222121122b22222212111111112211221212222012112221122202212211020a0111111111111111111
1111101101111101111111a11111111a100111111111111111121222212221120222001220222220222222b01202222011111222210211222020022222220101221212212100a1101111011111010010
0110111111001111111011a11100110a110010111101111101112120121222122222220221020220000022a21222102111122111212121221200201222212210011211111121a1101010111111101101
1011111110100110111110a11111111a101101111011011110110122212101212122222220120102022222b02202222001122102211102202222001002011221221202121111a1101111111111001011
0111111111101001111101a11111011a111101101111011110121220121002011222020202222222001112a12222221110110202110122111222020112202221221212111211a1111110001111101011
1101101011110111110111a11111110a111110111101111111111110100111202222201212220211022002a22222221011112222111002002022212221221022221111121121a1111011101100111111
1101111111111111111011a00011111a101110111111111111111101001111122222222121102121010220b21200202111112212122220202112121222122212021000120021a1111011111111111101
1111111110111101110110a11111101a110111001011010111111101111101112110202122122221012220a20202222111112022202022222222120202120112202122122221a1111101111101011111
1101111111101111111110a10111101a001101110011110111111111111110212120022021222222022220b22222211101110121101122021221211221222211221122221211a0101111100110111111
1111111111110111101111a11110111a101110111111111111110101111110220101101111022121022122b20220201111101210001102221122221202212221201221221111a0110110101111111101
1111101101111111111111a00010111a101011111100111111111101110110210011001121220221222010b20102201111022021102201222212220211222220211122211111a0111111101111101101
1111111101111110011111a11010110a111011011011110111101111111011112012220011010122121021a21222111110122210222222121220122201220202212112212101a1011111111111101010
1011011111111101101111a01110110a111111000111110111101111111011120111211122100212212121b12121011011122102220222222012212222222202220010101201a0101011110111111111
1111110101111111111111a11111101a110111110111101011111111111111101011120222102022111201a22120211010021222212122220222212202222220201222102121a1101101101011111111
1001101111011111111111a00101101a111111111111010101001110111111211110212202202121012111a10212111110121101222220200222202220022022221221121121a1111111110101111111
0111101110101011011100a11011111a110101111110111101111111111111211020121211121122221121a12212111010022222122222222222222222222020222000212111a1111111111111111010
0111101111011111111111a10111011aaaaaaaaaaaaaaaaaaaaaaaaaaaaaaababaababaa21021102210212b11222010111100221211222222022022222220112222211011211a1101111111110110111
1111011101011111101101a011111101011111111101111101111111111111112212212b12112212222000a12010211101122220222222202212220100212222222201220211a1111111110111110111
0111111111111101100111a111111011111111111111111111111111111110221022101b12211111100210b12121010111121022222220222212222222210212201011220221a1001111111101111111
1111101101010111110110a001111011101111001111110111101011101011102022212b01111111021121b22111111111122022221222222122220212222221201201112121a0111111011111011111
1111110111100111111110a011111111111111101111111101010111101111100002121a20201012220112a00100111111111221222222222121000222222222222122100021a0111111110111111011
0101111111101111111111a011100111111011111111001110011011111010022122112b11122122100020b12222111011102222221222202122202221202102002110121101a1111001101110110111
1111111110101110111111a110101101111111111011111111110110101011201110212a02210211111210a20122011101121112221022222222222201122022222222200111a1011111111101101101
1111111111111111111111a111111101111111110110111101111111101101102120120a02122122212120a01222201110120010201022222122222222220020202211100111a1011111011111011011
1111111111110101111111a111111111101110111011111011111111101111111201010b10021211021110b21010210111111202202102222022022222200202222210112101a1110111111011111011
0111101101101111111010a100011000110011101111011111000111101111112111000a22111012201212a21122211111111211021022122022122211012011212111011111a1111111011111101010
0111011010111001111111a111111011101111011101111111101110111110211100112b11200012100221a22101211101111212220022220112222122102211112211111011a1111111011001111111
1111111110110111110101a111011111101111011111111110111100111101122021212a11111221221220b21121201111001122112221121111122012100111202211111111a0011110111111001111
1110111110111110111010a110111110111100110110110001111011111111211121202a22211210120210a21121111111101122121111112121220221020011221111101111a1111111101111110100
1111101111110111101001a111110111111110011011010111101111100111111111101a11111111111101a10111111100110111222211222122212222110222201211111111a1111111111111111110
1111111110111110011011a111111110111010111110111011111101111111110001010a11111111111101a10101011110111101221202101220221122221211022111011101a1111111110111110111
1001000111111101101111a111111111111111101101111110011111110111111111111a10111111111111a11111100111111121011210120200122112121212120111111111a1100110111101011111
1111111011111111111011a100111110111111101111001011100011111111001111111a11111111111010a10111111101111211222222111120112201222120211011111011a1111011111111111110
1111111011111111110101a011100111111111111111111101111111011101111111011a11100011011011a10111111111011211022002212012212011112021012211110110a1111011101111111111
1111011111111101111111a111101111001110111111110110111101110111111111111a01011111111110a11100111101111020020222122212120122211111022101111101a1111011101110111101
1111000111111010010011a111111111111111111101111011101111111101111110110a11001111111111a01101121220011220212220222111122221221012221111001110a1111011111111111110
1110101110100100111101a111111110111111010111101010111110111111101111101a11111111111111a11111120112220222222202122120212222221222122211111001a1110111101111011011
1111111111010101101110a111111110101101001111111110110111111001101111011a11111110101111a11111111101221222210212222122220222112111111210111111a1111100001111001011
0111111110011110111101a111111101011111011111111111111011001111001111011a11001110101011a11001121111010122220222100222222002201012222210110101a1101111111011001111
1111111011111101011101a111101110111111101111111001010111111111010111110a01111111111111a11010011112202021222211222212222222022112001210111010a1111111110111111100
1111011010101111111111a111101111111111011011101011111101000100001011110a11111110111110a11111101021001222001112022212220202221221002111111110a1111101111111111111
1110111111111111111011a010110111110101101111101011111110110110111110111a10111110111111a01110111001220120122221221222102222022120012111111011a1111101111111111110
1011101111110011100101a111111111100110111111111011101101111111011111111a11111111111111a11111111111022210200122221100011121111111111110111111a1000110111010111111
1111101111110011111011a111110011111101111111100110101101111011111011111a01010111111111a11110112220112100100122120212222122221111111110111101a1111001101011101011
1111011100111011110111a101111101000010111111011101111110110101111111101a11011111010111a01100012221121222112220211022202011121111011010111011a1110111111111101011
1111100101111111011111a111111111101110110111111111101111101110111111111a10111110111110a11001112121202112211011202122221111021111111101101011a1111110110111111100
1111011111111101111111a110011011110111111011111111111111111111111111001a11011111110111a11011112121211000220211110201211122121111111111111111a1111110111111110111
1111111011111110111111a111111101101110110111111111111111111111100111111a10110001111111a11111111201001011112112121122202200211111111110110110a1111111110111011111
1011001001011111110101a001011111110111111101011111111110111110101110100a11111111111010a11010112001211001212211202220210111211111111111011111a1101111111111111111
1111111111111111110111a011111101111111110111010111101111111111011111101a10111111111111a01111102011121222101101110122212111101111101111001111a1111111110111111011
1111101111111111111111a011110101111010110111111111110100111111111110111a11110111101111a10111122112201121021202112111211111211111111111110100a1101111111111011110
1111001111001010011110a111010111011111111011111111011101111111010111111a10110111110110a01111121221221022121122212021110120021111111111111111a1111101001111110101
1111101101111111111111a000111110001010001111100111010110011001111111001a10111010111101a11011100211122112221211120222210111220111111111111111a1110111111111110101
1010111110101111011111a111110111111011111111101111111010111101111111111a11110111111011a00100121100112011111210022200112111120111111111011111a0110011111011111101
1111111110111110001101a111101111111110111111111111100100001111111011111a01101111011111a01011112210222112121122222101112202011110111010101111a1111011111111111111
0111011111011111111111a110111111001110000111011110111110111010111111000a01111111101101a01111112211212101002122101001201101221011110111011111a1111111011011110011
1101111111111111111110a011011011111111101010110111011111111101010111111a10110110110111a11100120021021102112101022100122211111111111101001101a1111111110111111111
0110111010111111111011a111011111011111011000111111010111001001111110111a11101110111111a11111111221112111111201022121222212011101110111110111a1001111110100101111
1100111110111111111011a110111011111110111111101111111111010100011011111a11111111111101a10110120122102111220220211121202102111110111111111111a0011111110111111011
0111101001101111101111a111101111111111111011110111111101110110011111011a11011011111111a11111101121221112221022101012121121101111101111111111a0111111011111101011
0111101111101111111110a110111111110111111101111001111111101101111111100a11111111101011a11111121111112011202112221021211120111111001111101111a1011111110110011101
1101111111111111011111a111111101111111101111111110110111111111110111101a10101111111111a11101120122021221011022222102201221001111111111111011a1111111111111100111
1111111001111111101111a111101111111100111111111111011111001001011100101a01111111111111a01101121201021222201110211210012211101101110111111110a1111010111111100111
1101111100011111111110a110111101101011111111111111110011101111110111111a11111011111101a11111102101221221121011112111201212221111111111110111a1110111111111100110
1110101011111111111111a111100111111111111110010111011111111111111111101a11111101111111a11101120201011212122120112001112121111010111001111010a1111111111111111110
1111111111011111111111a111101110101110101101111101111100110111111111111a11101111101101a11111122012210221110121121022122210201110111011101011a1111111011100011111
1111111110110101111111a111110111111110100110111110111011111011111111110a10111111111111a01111111011111101101111111111111111111011111111111111a0011111111101111101
1111010111111110010110a101111110011011111111111111111111111011111001011a01011111111111a11111111111011110111111111110110111111110011110111111a1011010101111110111
1110110111111111101111a101111111011111111111101011101111011111111111111a00111111111111a11111111110111010011111111111111110101010111101111111a1101111111111110011
0111111111111111111011a111111101111011001011111111111111111111111111111a01111111110110a11101010111111111100111001111111111111111111101111111a1101011101101011101
1111000111111011111111a101110111110011101101110011010111110001111111111a11111100111101a11111101111101111111111110111101111101111111111111111a1110110111110111011
1110111111011111111011a101110111111110111111111111111010010110110011111a10011111101111a11111111011111111111110100111001111111110111011011101a0111001111111111111
1111100111111111111111a111111101011111011111110110111011111101111101011a11111111101111a11111011111111110111111010110111101111111111111011111a0111111111111111111
0001011111110101111101a101110111111111101111111111111111111100111111111a11110111111111a11111100111110101111101111011100010111111111111100111a1111110111111110111
1100111111011011111111a111111111011101111100101111111111100110011111111a11100101100111a11101110101111111111101111111101111101010111111101000aaaaaaaaaaaaaaaaaaaa
1011111101101101111111a100011111111111001110011111111101101110000110101a11101111110111a1110011111011111111110101111101110100001111111111111100010101101110111111
1111111101110011100111a111111001110011100111110110111111111111110110011a10111111111111a1001111111111110111111111110111110111111111110000111011011111111111101101
