101 84
2 152
106 22
76 4
96 81
52 137
34 88
100 118
97 157
62 58
011111101111110111100111010111111110110a111111110111111111111010111111101111010110a01110110111011001101110111011101111111111010111111110111101011010101111111101
011000011110111011110111100100011111111a100111111001111101111101111111111101111011a01111110111111111110101110100101111101001111101111101110001111000011011100111
1101111111000110111aaaaaaaaaaaaaaaaaaaaa110111011101111110111111010111111100111111a11011101111110100111010110111110010110101110011111101011111001111111111111111
1111100111111111111a10111111111111011111110111011110111101111111111111111011111011a11101011111011111101111111111110110111000111001111111101100111111110111111111
1111111111101111101a01010111111111111111110011111011100111111111011111110111110111a11111101111111011111111101011011111111011111010110100111101111101101111111011
0011100100111111111a11111111111111111110111110011101111111111111001111111111101111a11111011110111011111110111011111101111111111000011111101101101110000011111110
1111110111111111111a11111011111110111110111111110111111011110111111101100111111001a11111111111101000111110010011011111101111111101111101111111111111110111111110
1111111100011111111a11111111011101111111110111111011011110111110111111111111111101a11011111111110011111111111101101111111100111111111111111101101111111110101111
1111111111110111011a11011111011011111010101111101111111011110111111010110110010011a10111011111110100111111110111110101110111101111101110111011111111111011111111
0111001101101011110a01011010110111100111111101011110101111111110111111111101010011a11111011001101111110010101100110001101101111111011111110101101111111110111110
1101101110001100101a01101001001111011111001011000111111111101111100111101111000110a11011111011010110011101011011011110111111110111111111111111111111011111111111
1111100111111111111a10111111110111111011111111111000111011111101010101111111111111a11101110111111000111111101111011111111011111110111110111110111011111111111111
0111111111011111101a11100010111111001111010110111111111111001011101011111011110110a10011011111111001111111110101111101101111111001101111100011101111111011110001
1111111111110100010a11111011111110101111101111101111111110101011111001110111111100a11111011111111110111111110111101101111111111111111011101111011110011111110010
1000111111101111110a01011111111011111111101111101111111111111100001111111111101110a11100001010111111011011111010110010111111111111101111101101101111110100011111
0000101001111110011a01110111101111111101111111111111111111110111111111100110111111a10100110001111101111101100111101111101011001111100111101011101111010111111000
1111111011111110010a11011110100111011111111101111100111101011111111110011111111111a10111110111101111111101111111111010111101111110111101011111110011111110110111
1111111011101110111a11110010111111111101111011110111110111111111111111011111111011a11001110011111111111111011111001111010111111111100111111110100111011011101111
1011111101011001111a10111111010111110101101010011011111110111010011110111011111111a11011111110111000111111000111110010101101010111011011111111111101101011110101
0111011111111111100a00111110111111110111101011111101011101111111101011111020012221a22222220202112021100101101101111110111111111111111111111101111101110011111100
1011100101010111011a10111101011101110111111011011011110101111111101111101212012222a01110111021202021201211101111111101101011111111111010111111101110100110110111
1110110011011011110a01111110110111011111111101111111111110111111101110101221011120b11202121001122222212201111010111111101110111011111111111011111001111111101111
1111111000111111010a01110111011100101111111001101111001011111111101111111202220012b02212120222012121221000101111101101111101111110111011111100111011111111111111
1101101101101011110a10111111010101111011111111111111111110110111101111101222201101a10212211022212221112211011110110001010111011111111011111101111111111110110111
1111101110110110111a11111111110111111111101101110101111111111011101111111111120110a10121111210112112121101111111111110111111111110101011101111111110111110111111
1110101110111111111a11101011011100011110110111111110111111110111110111111121121111b02012002122222211120111111011111110111010111101011111111111101110111110111001
1111111111011110011a11110111101001001011101101111111111111111111111011101121111222a11221012201210022000210111111011111111011111100101111111111011111111101110101
1111111011111011011a01101111111010100111100101111110110100111110111011100010202222b200110112211102211012111111111110110101110111111111011110aaaaaaaaaaaaaaaaaaaa
1100111011011111101a10011111011101011011111111110111111111011010111011101111022200a100011112112220210111111110101111111111100111001110111111a1111111111111011101
1111110111111010110a00111100111111010011101111110111111111111110111111110222012111b122110101111111111111111111111111111110111101111111110111a1111110111110111111
1100111111101111111a11101011111101111101110110111111110001111111111101101122012020b001212110011211221120101100111111111111111011001111111110a0001111010111011010
1111111011111111110a11111111111011101101110111101011110110001111110010011122211122b222202222222221020002110111111111111110111010111011111111a1011111111111011111
1110100111111111101a01111111011111100111111101111001010110110111111111110222121111a022012222112211010122100110111111011011111111101111111111a1011111111111111111
0011010110111111010a00011111111111101111111011111111111111101110111110101221011122b121111002012212121222110111101011011010101111011111110111a1111010101101101011
1111111101110111111a11111111111101111001011111111111011111111101111101111212221200a221120220112112202102111110110111011111101101111100110011a1111111111111110111
1001111111100111101a11111011011110011111101111111111001111111111111010111022111211a202222111110122210222011111111001111100010110111111110111a0011111110101111111
1101111101011111110a11111110111110001111111011110011111101011111111101101022012110a211112121201222211002111101101011111111111110111111010101a0011110011011010111
1011001111110011110a10101111110111111110111111111111111111100111111100011222111010a120111112212222000111111111001111111110122220020122110121a0001122011120110111
0111111111001111111a11011011111101111101001111111110100110111111111101111121112121a122220200210212211200111111111101110111102021111101110112a1012122111121111111
1111010111110111101a11011101111111111111110100111111111111110111101011111210122102a121112210202221201001110011101100111110202211211102122122a1222221221111111110
1111111111111111100a11111011111101111100110011000111111111011101101111111222200111b012222211200111221211011011101011011111222020012221112210a1002112210121111111
1111111111111110111a11100110111101111010111011110111111001011101001101111222212121a012102222122201101221111000101111111111200210100111010122a2021020121220111111
1111110111111111011a11111111010111111110111011110000111011111001011101011111112221b122120012111111211202111011101111111011022101212122201212a1122221201210111111
1111111100011011110a01111101101010111111111100111011111011111111011010101010110201b220121121110011010221101111110011011011210201122021100121a0201112110220111101
1111111111111111111a11111111110111111011110101111101111011111010111011001222121212a101121212022012021011110111110101011101211012120020100012a1011221020121011100
1110111111111111111a11111101111011111111111111111010111111111111111011111110111122a120211111012021200112001000111111011111112201010202210221a2111201101201010101
0100111111010111111a10101101111011111100111101011111111111110111101011111210111222a022221120102010100212111111001110101001122111200222112121b0122111212121111101
1011001101100111011a11111111111111100111111121212120210012022022220020110210022012b102011212212020221210110110011111111110112221211212212112a0012211210011101110
1111111100111111011a11011111110101111101011220012122001201011212020222112121202022a022221121201121221221111111111111111011101121221112211110a1221012112101010110
1101111111111111101a10111111110111010011001122211210112210000012121101011211001112b021102121121221222210111101011011111111112112121212022112b1210202111011110101
1101001111111111111a01011111110101011110010102211111112020211121120222221111101111a011000111011101000111111110111011110111021111102220022021b1101021022121111101
1111111111111111111a11110101111101111111001121111001120000211001011101111211110001a111111111111111001111101101111111100101212211121220000221b1221211122121101011
1111111001110101111a01111101111110111010111122212211122112111220222121001011000111a011110111001111111101101111111011111001221022220112100201a2112021121011110101
0001111011111010111a01110111110111111101111120200122000101122101200211120111111111a111011101101011001111111111011101101111012010121122212011a2001110121211101111
0111111111101011111a11111111111111101111110022221122212121201222002222001111010111a111111111101111111110111001110111011111101021010212122112b0000201112011111111
1111110011111111011a11101111101110101010111201202121112221222011121112112211111110a101111001111111101111111100111101011111221120211201112100a0012110102201110111
1110010110111011111a01011111011010111101111122222121001222102021110100200111101110a101010111111110111101111000111010111111112020100011112111a2221020000011101110
0101111101010111101a01111111101011111001111121012222001202120010000212102001111111a110011011101010111101110110110111101111111120122111112212b1011212111101111110
1111100110011101101a01101011110001011111110220112121111222000111122212121101110111a111100111111111111111111110111111111011220012111102111112a1110021212211111011
1111011111001011111a11111111111111111011011102120102220222120122022202020211011101a111111111111001101111110100111110111110110102111210120112b0101212112111111101
1111111111111110101a11000101111111101111011110021122211021212222010101201011111111a111111111101111101110101111111111111101021110110021120121a2201000012211011111
0111211121022011212a11010111011111111011110212222201001122222211022220200211100111a111101110111111111111111110110111111111100122102011110202b1212111022001101101
aaaabbbbbaaaaabbbaaa11010111000111010110110121120110210102210202122112220211110101a111111101111111110110111011111111111111121101121111120201a0111001011001110111
2212102111100222012211111011111011110011001111212021121122022001201122212011111111a101101111111111111101011011111111001001002110012112122120a2112012121121111111
0002111200211122010110111111011011111111110111211010201210020121022211102101011010a111001111111011111011111111101111111000111220121101002122b1102122122001100011
0110112001210210111201111111111100111111111001121002121211121220100120121211111011a111111111110011100111111111111010111111211111201122211122a1112210120220111111
1100122101122100212211011010111011100111111112210012211221212222122212210001111111a111111110111110100111010111111011111111202112121221011010a0212111121210011101
1022221111112212222201111111100101111111111112220220002022020212121110201210101111a110111111110111111101101111101111111011200022210022200201a1221222222221111111
2021221220120222202111001100111111110110111112120112102102221002211210111110111011a111111111011111111111101101111010011100001100111110111111a1111111111101111011
1112221112211221120211111010101101111111001102112110010221211222210211111110111011a110111110111001111111110111111111100110111110111110110111a1111111111011111111
0011011111221010210211111111110111011111110202111021002121111120220121211111110111a110101111011110111111110111000111111111110000011111111001a1111101111111111101
0112011212020212220111011101110011111101111212221221012022011101121112112211111011a111111101111111111101111111111111101011101011111011101111a1100111011111110110
1221011100212011202211011011111111111100011210211201202211211012211122202110111101a110111111111101111110111111011111111101100111011111101011a1011111111110011101
2122122010202021212210001111111011011111011122021201122020221101112222001111011111a111111001011110111111111101111111111110011011111111111111a1101111111111111011
1212010221212211221011111011111111110101111211011222201011121022011222112011110110a111111011100111110011100111111111111101101011101011110011a1110101111101111111
2210122222012220211111100110110101111011011212121121222011220112112111002211111111a100111111111111100110111110110110111011101111101111111101a1101001111111111111
0220020210102211100001101101111111110111111000222012201022111110202220101201100011a111111001111111011011011000111100011111111111111111111011a1111101111111111111
1201122221222222222211111100111010001111111100102202111012210102212212101111111001a111111111101110110111111111011111110101110001011111100001a1111111110100111111
2011102111111211101011111111111011111111110100011111011111111101110111111110111111a101111111101111101111111111011111110010110111011111111111a1111111101010101001
201122020210221221221101111111111111111011aaaaaaaaaaaaaaaaaaaaaaaaaaaaaaaaaaaaaaaaa111011111110111101111010010101101111111111011111111111110a0110111110111000111
212111112002210211111111011110101111011111a1111111101011111111111111111aaaaaaaaaaaaaaaaaaaaa111111101111111110011011111011111110111111111101a0110111110111101110
101020222121221122221111111111110011111111a1011111111101111101111102222b1200112212122100102b121211111111101111100110111101111111111111111111a1111111110110101001
210121021201121211201001111100111111110111a1111011111111111111101112010a2211111211212102002a212101111111111011111111111111011111100111111110a1120122121221220222
112220212111121122000111011000111100011111a1111010111111111111011020022a1111121200100002211a201210111011111111011111011111101101111101111111a1121011120100101012
111121111220201101211111111110111011011110a1001101111111011111111111120a0112222112220220111b201121111111111001111111101000111001101111111110a0222120111200211120
121022021001010121211110110111111110111111a0100111110111100111111101222a0121122020222112212b202021110110110222112210122200122121100212111111a1112212111111110102
212211212102012122221111111011111101011101a0101111010111111011101101100a2101222020222112010b110101101110222110201101011220122001212122010110a1011200020111110110
222120012110111121221011111110110111011111a0111111111101101111111110212a1112111111222122201a222121110112000112222101012112222022022211111111a1201212112122121110
001002022212012220011111101101011111011011a0111111111111100101111102122a1120221211212211211b220221101110221001212212122202122002112122101111a1010112200201122002
112221101110121111201101111011010101110011a1111100111101111011111022111b1221100111102121202b121211110111100122120201120222110202012012110111a1222122222212002221
122112110121011111110101001111011011110111a0101111111111101111111112101a1002021111211202212b211211110011211212111122012222110200120122111111a1100111020102212020
101101022022212220222010110122212102100011a1111010010101000101111120102a0111221212021012110a012021011111212102220210222222022010101121111111a1122011222122012212
111111111200211212112012222122011102201011a1110110111111001110111102121b1221112221122111121a212221110111112222211020021212111001201121110101a1121122122210022112
101110122011121022222111122212221110221101a1011111111111111111111111200a1121111111111122202a011221101112212212211121012121022211021120110111a1112212022022001200
111100110121210021102212211122102122221111a1111111100101011010111122110b2112012110212121212b221000111101211002201021121110221222222212111011a0111212221211211121
101011001111221021112021111001212211221101a1101101111111011111111102120a1201111112001112121a220201011011212012221011120221111022110022110111a1022100112111020111
111111120020212122001212012210121221021111a1111101101010111110111002221b1220021222211022121b221021111110110111211212022021102200202221111011a1212121011120122121
011110011002101122210200221112212211121111a1100101011110111111111110012a2210122210200102012a111111111112112112121112011201111221022221111100a1111202220220221012
111110121101122212201202120020101102111111a1011111111111110101111120221a0221200112112121102a112111111110210222101221122112212212222121100111a1212220010101211012
aaaaaaabaababaababbabaaabababbaaaabbaaaaaaa1011111100111111111010112122b1222112110002101021a212020111111122222212012222010222121210222110111a0211202200212021121
01001010100211102202222111201022111221011111011011110011111110010012002a2100220001022202102b220221110112002101121222102122012112122122101110a1222112020101110121
01111112212121112221220121212101222221101011000111011110111111111012201a0112122100021202211b212101111101011020112112220222200102211210111011a1022221020012220120
11001112010002022212112122112121220110111101111101101111011101110022111a2102210112110012200a122201010111200221011222011102210222112211111011a1221112221122212212
11111111212110012012222002112012121120111111011111011111100110111100110b2120211011211112112a021121111110100200212211221211211220211021110100a0001211202111221122
10111111211112200211121111020121210210111101100110100101110111111122211a2122011222011110201a202111101112012201101001012122202201122122110111a1201100012220211210
11110111122221202210021221221221221212011111110111011000011110010101211a0022122211012222122b012221110111211110202222210122222201221110111111a1001112021211212002
11110110012121122111221000002202112102101011100110110111111011100120212b2212200012121100212b222111110100221102222201002002111122020210111011a1122102212202202102
11111112112120121111112211021011111111111111111111111111111111111111011a2222120211102112102a012121101101011101011221211221112011212101111110aabbbaaaaaabbaababab
11111012112211011210201112211222212122111101111111111011111110111102012a2122201121222211112b12211110011122211020022201012212020220200101011011212121110120221121
11111012222221212221111202221011112211111111111111110111011101111111201b1112022012221121212b22111111011111011110111212101220201001202110111101112221212222112020
11111101111001201212112002201122220202111111111100110011101111111111011b1102222102112012112a01202110011100100212110112211020122201222210111011102102010201122222
11100102100222201212210200221112221221110101101011111101111111111120202a0122221020222121122a22212110111020100201102021212122211201111211110111210210100022010211
11111011202222212112200010100200020122101011011110111101010111111111111a1000111110111111011a11101011011221112000122121021121201022201010111110110122122221222111
00111111011111012011211101100122101210111111111111110110111101011111011a1010101111111111111a01111111011102221202122111022210120020101101010011100111111111011101
11111112121210022121122112202201110210110010111110111111100111011111011a0111011101010011100a11111111010222122021101000010011010210111010111110111010011111110101
11111112112100221020122110222022101010011110011011101111111111101111111a1100101110001101101a11111001111001211222200211002100122000001011111111111111011011111011
01110111022022212120101112221012220202111111111111111100101111010101011a1111110011001111011a11111011111111101011110111011111101111111010101111111111111010011101
11111100012012120221201111002221111020011110110101011111111001111111110a0111110011111111011a01111101111111111111111101101111111111111101111111111101001001011011
01111112212212110110011222121101122201011111001111110101111111101011111a1101011111111111011a11101110010110111010010111011111011101110110110111111111111111011111
10101112202202001021211111122020111222101111111110010111110011011011101a0110111110110111111a11111111111111101111111111111111101111111111111110111111111111111010
